,Entity's Name,LOC Count,Header Count,Annotation Count,Inner Entities Lines,Total,Entity Type
,/plugins/FindInFiles/src/FindInFiles.java:default.FindInFiles,211,9,0,17,237,CLASS
,/plugins/FindInFiles/src/FindInFiles.java:default.FindInFiles$MyCellRenderer,17,0,0,0,17,INNER_CLASS
,/plugins/FindInFiles/src/FindInFilesMatch.java:default.FindInFilesMatch,36,0,0,0,36,CLASS
,/plugins/FindInFiles/src/FindInFilesHelper.java:default.FindInFilesHelper,91,9,0,0,100,CLASS
,/plugins/FindInFiles/src/FindInFilesPlugin.java:default.FindInFilesPlugin,25,4,0,0,29,CLASS
,/plugins/FindInFiles/src/FindInFilesOptions.java:default.FindInFilesOptions,14,4,0,0,18,CLASS
,/plugins/Java/Options.java:default.Options,143,1,0,190,334,CLASS
,/plugins/Java/Options.java:default.Options$Display,111,0,0,0,111,INNER_CLASS
,/plugins/Java/Options.java:default.Options$DisplayIro,21,0,0,0,21,INTERFACE
,/plugins/Java/Options.java:default.Options$Filter,49,0,0,0,49,INNER_CLASS
,/plugins/Java/Options.java:default.Options$FilterIro,9,0,0,0,9,INTERFACE
,/plugins/Java/ClassBrowserOptions.java:default.ClassBrowserOptions,14,4,0,0,18,CLASS
,/plugins/Java/JavaPlugin.java:default.JavaPlugin,22,4,0,0,26,CLASS
,/plugins/Java/JBrowse.java:default.JBrowse,174,9,0,166,349,CLASS
,/plugins/Java/JBrowse.java:default.JBrowse$TreePane,100,0,0,0,100,INNER_CLASS
,/plugins/Java/JBrowse.java:default.JBrowse$Activator,7,0,0,0,7,INTERFACE
,/plugins/Java/JBrowse.java:default.JBrowse$OptionDialog,59,0,0,0,59,INNER_CLASS
,/plugins/Java/BeautifierOptions.java:default.BeautifierOptions,30,4,0,0,34,CLASS
,/plugins/Java/UMLTree.java:default.UMLTree,42,5,0,280,327,CLASS
,/plugins/Java/UMLTree.java:default.UMLTree$Model,38,0,0,0,38,INNER_CLASS
,/plugins/Java/UMLTree.java:default.UMLTree$Node,176,0,0,0,176,INNER_CLASS
,/plugins/Java/UMLTree.java:default.UMLTree$CellRenderer,66,0,0,0,66,INNER_CLASS
,/plugins/Java/JBrowseOptionPane.java:default.JBrowseOptionPane,333,6,0,38,377,CLASS
,/plugins/Java/JBrowseOptionPane.java:default.JBrowseOptionPane$OptionPanel,38,0,0,0,38,INNER_CLASS
,/plugins/Java/JSLineBreaker.java:default.JSLineBreaker,342,1,0,18,361,CLASS
,/plugins/Java/JSLineBreaker.java:default.JSLineBreaker$LineBreak,18,0,0,0,18,INNER_CLASS
,/plugins/Java/UML.java:default.UML,3,2,0,313,318,CLASS
,/plugins/Java/UML.java:default.UML$Type,32,0,0,0,32,INNER_CLASS
,/plugins/Java/UML.java:default.UML$Element,41,0,0,0,41,INNER_CLASS
,/plugins/Java/UML.java:default.UML$PackageMember,22,0,0,0,22,INNER_CLASS
,/plugins/Java/UML.java:default.UML$NestedMember,27,0,0,0,27,INNER_CLASS
,/plugins/Java/UML.java:default.UML$Generalization,23,0,0,0,23,INNER_CLASS
,/plugins/Java/UML.java:default.UML$Message,16,0,0,0,16,INNER_CLASS
,/plugins/Java/UML.java:default.UML$Operation,69,0,0,21,90,INNER_CLASS
,/plugins/Java/UML.java:default.UML$Operation$Argument,21,0,0,0,21,INNER_CLASS
,/plugins/Java/UML.java:default.UML$Throws,19,0,0,0,19,INNER_CLASS
,/plugins/Java/UML.java:default.UML$Attribute,43,0,0,0,43,INNER_CLASS
,/plugins/Java/JSFormatter.java:default.JSFormatter,686,2,0,0,688,CLASS
,/plugins/Java/ClassBrowserGUI.java:default.ClassBrowserGUI,20,4,0,0,24,CLASS
,/plugins/Java/ClassBrowser.java:default.ClassBrowser,349,12,0,0,361,CLASS
,/plugins/Java/JBrowseLineParser.java:default.JBrowseLineParser,923,1,0,0,924,CLASS
,/plugins/Java/JBrowseLineParser.java:default.ParseState,20,0,0,0,20,CLASS
,/plugins/Java/JBrowseLineParser.java:default.ParseSubState,30,0,0,0,30,CLASS
,/plugins/Java/BackStab.java:default.BackStab,40,0,0,0,40,CLASS
,/plugins/Java/JSBeautifier.java:default.JSBeautifier,734,2,0,0,736,CLASS
,/plugins/Java/PropertyAccessor.java:default.PropertyAccessor,6,1,0,0,7,INTERFACE
,/plugins/Java/RWModifier.java:default.RWModifier,202,1,0,0,203,CLASS
,/plugins/Java/JBrowseParser.java:default.JBrowseParser,9,1,0,59,69,INTERFACE
,/plugins/Java/JBrowseParser.java:default.JBrowseParser$Results,50,0,0,0,50,INNER_CLASS
,/plugins/Java/JBrowseParser.java:default.JBrowseParser$LineSource,9,0,0,0,9,INTERFACE
,/plugins/Java/Beautifier.java:default.Beautifier,61,5,0,0,66,CLASS
,/plugins/Java/TokenSource.java:default.TokenSource,201,1,0,8,210,CLASS
,/plugins/Java/TokenSource.java:default.TokenSource$Exception,8,0,0,0,8,INNER_CLASS
,/plugins/Java/InsertClassName.java:default.InsertClassName,154,12,0,0,166,CLASS
,/plugins/Java/JBrowsePlugin.java:default.JBrowsePlugin,16,15,0,150,181,CLASS
,/plugins/Java/JBrowsePlugin.java:default.JBrowsePlugin$OpenAction,50,0,0,0,50,INNER_CLASS
,/plugins/Java/JBrowsePlugin.java:default.JBrowsePlugin$OptPane,11,0,0,0,11,INNER_CLASS
,/plugins/Java/JBrowsePlugin.java:default.JBrowsePlugin$PropAccessor,18,0,0,0,18,INNER_CLASS
,/plugins/Java/JBrowsePlugin.java:default.JBrowsePlugin$TreeEventAdapter,71,0,0,0,71,INNER_CLASS
,/plugins/Java/JBrowsePlugin.java:default.JEditLineSource,69,0,0,0,69,CLASS
,/plugins/Java/BrowserLauncher.java:default.BrowserLauncher,364,7,0,0,371,CLASS
,/plugins/KeystrokeRecorder/KeystrokeRecorderPlugin.java:default.KeystrokeRecorderPlugin,31,4,0,0,35,CLASS
,/plugins/KeystrokeRecorder/Track.java:default.Track,21,3,0,17,41,CLASS
,/plugins/KeystrokeRecorder/Track.java:default.Track$Command,17,0,0,0,17,INNER_CLASS
,/plugins/WheelMouse/WheelMouseOptionPane.java:default.WheelMouseOptionPane,45,7,0,0,52,CLASS
,/plugins/WheelMouse/:sun.awt.DrawingSurface,2,1,0,0,3,CLASS
,/plugins/WheelMouse/:sun.awt.Win32DrawingSurface,5,1,0,0,6,CLASS
,/plugins/WheelMouse/:sun.awt.DrawingSurfaceInfo,9,1,0,0,10,CLASS
,/plugins/WheelMouse/JFrameEx.java:default.JFrameEx,76,11,0,0,87,CLASS
,/plugins/WheelMouse/WheelMousePlugin.java:default.WheelMousePlugin,44,8,0,14,66,CLASS
,/plugins/WheelMouse/WheelMousePlugin.java:default.WheelMousePlugin$WindowAWTEvent,14,0,0,0,14,INNER_CLASS
,/plugins/Php/src/PHPIndenterBloc.java:default.PHPIndenterBloc,15,2,0,0,17,CLASS
,/plugins/Php/src/PHPIndentPEAR.java:default.PHPIndentPEAR,162,1,0,0,163,CLASS
,/plugins/Php/src/PHPIndenter.java:default.PHPIndenter,15,2,0,0,17,CLASS
,/plugins/Php/src/PHPQuickOpen.java:default.PHPQuickOpen,45,4,0,0,49,CLASS
,/plugins/Php/src/PHPBrowseTabNode.java:default.PHPBrowseTabNode,36,2,0,0,38,CLASS
,/plugins/Php/src/PHPParser.java:default.PHPParser,352,0,0,0,352,CLASS
,/plugins/Php/src/PHPIndentHTML.java:default.PHPIndentHTML,145,0,0,0,145,CLASS
,/plugins/Php/src/PHPModifierFichier.java:default.PHPModifierFichier,44,1,0,0,45,CLASS
,/plugins/Php/src/PHPModifierSelection.java:default.PHPModifierSelection,62,1,0,0,63,CLASS
,/plugins/Php/src/PHPBrowse.java:default.PHPBrowse,19,9,0,0,28,CLASS
,/plugins/Php/src/PHPIndentPHP.java:default.PHPIndentPHP,75,0,0,0,75,CLASS
,/plugins/Php/src/PHPCompleteListHandler.java:default.PHPCompleteListHandler,32,2,0,0,34,CLASS
,/plugins/Php/src/PHPBufferPartList.java:default.PHPBufferPartList,76,1,0,0,77,CLASS
,/plugins/Php/src/PHPBeautifierBloc.java:default.PHPBeautifierBloc,15,2,0,0,17,CLASS
,/plugins/Php/src/PHPBeautifier.java:default.PHPBeautifier,15,2,0,0,17,CLASS
,/plugins/Php/src/PHPBrowseTabParser.java:default.PHPBrowseTabParser,65,3,0,0,68,CLASS
,/plugins/Php/src/PHPFunction.java:default.PHPFunction,12,0,0,0,12,CLASS
,/plugins/Php/src/PHPIndent.java:default.PHPIndent,21,0,0,0,21,CLASS
,/plugins/Php/src/PHPComplete.java:default.PHPComplete,23,10,0,0,33,CLASS
,/plugins/Php/src/PHPModifier.java:default.PHPModifier,17,1,0,0,18,CLASS
,/plugins/Php/src/PHPBrowseTab.java:default.PHPBrowseTab,108,14,0,0,122,CLASS
,/plugins/Php/src/PHPPlugin.java:default.PHPPlugin,19,3,0,0,22,CLASS
,/plugins/Php/src/PHPCompleteList.java:default.PHPCompleteList,40,4,0,0,44,CLASS
,/plugins/Php/src/PHPBufferPart.java:default.PHPBufferPart,27,0,0,0,27,CLASS
,/plugins/Php/src/PHPCompletePopup.java:default.PHPCompletePopup,94,7,0,109,210,CLASS
,/plugins/Php/src/PHPCompletePopup.java:default.PHPCompletePopup$KeyHandler,81,0,0,0,81,INNER_CLASS
,/plugins/Php/src/PHPCompletePopup.java:default.PHPCompletePopup$MouseHandler,8,0,0,0,8,INNER_CLASS
,/plugins/Php/src/PHPCompletePopup.java:default.PHPCompletePopup$FunctionsCellRenderer,20,0,0,0,20,INNER_CLASS
,/plugins/FunnyBrackets/src/FunnyBracketsPlugin.java:default.FunnyBracketsPlugin,21,3,0,0,24,CLASS
,/plugins/FunnyBrackets/src/FunnyBrackets.java:default.FunnyBrackets,41,3,0,0,44,CLASS
,/plugins/FunnyBrackets/src/FunnyBracketsPopup.java:default.FunnyBracketsPopup,67,7,0,15,89,CLASS
,/plugins/FunnyBrackets/src/FunnyBracketsPopup.java:default.FunnyBracketsPopup$KeyHandler,8,0,0,0,8,INNER_CLASS
,/plugins/FunnyBrackets/src/FunnyBracketsPopup.java:default.FunnyBracketsPopup$MouseHandler,7,0,0,0,7,INNER_CLASS
,/plugins/KLNF/:com.incors.plaf.kunststoff.KunststoffScrollButton,30,5,0,0,35,CLASS
,/plugins/KLNF/:com.incors.plaf.kunststoff.KunststoffInternalFrameUI,45,6,0,11,62,CLASS
,/plugins/KLNF/:com.incors.plaf.kunststoff.KunststoffInternalFrameUI$PaletteListener,11,0,0,0,11,INNER_CLASS
,/plugins/KLNF/:com.incors.plaf.kunststoff.KunststoffMenuBarUI,20,5,0,0,25,CLASS
,/plugins/KLNF/:com.incors.plaf.kunststoff.KunststoffComboBoxUI,12,5,0,25,42,CLASS
,/plugins/KLNF/:com.incors.plaf.kunststoff.KunststoffComboBoxUI$MyMetalComboBoxButton,25,0,0,0,25,INNER_CLASS
,/plugins/KLNF/:com.incors.plaf.kunststoff.KunststoffTextAreaUI,26,5,0,0,31,CLASS
,/plugins/KLNF/:com.incors.plaf.kunststoff.KunststoffTableHeaderUI,23,5,0,0,28,CLASS
,/plugins/KLNF/:com.incors.plaf.kunststoff.GradientTheme,7,4,0,0,11,INTERFACE
,/plugins/KLNF/:com.incors.plaf.kunststoff.KunststoffProgressBarUI,36,5,0,0,41,CLASS
,/plugins/KLNF/:com.incors.plaf.kunststoff.KunststoffTreeUI,29,6,0,0,35,CLASS
,/plugins/KLNF/:com.incors.plaf.kunststoff.KunststoffListUI,58,5,0,0,63,CLASS
,/plugins/KLNF/:com.incors.plaf.kunststoff.KunststoffTextFieldUI,28,5,0,0,33,CLASS
,/plugins/KLNF/:com.incors.plaf.kunststoff.KunststoffInternalFrameTitlePane,17,4,0,0,21,CLASS
,/plugins/KLNF/:com.incors.plaf.kunststoff.KunststoffUtilities,43,3,0,0,46,CLASS
,/plugins/KLNF/:com.incors.plaf.kunststoff.themes.KunststoffNotebookTheme,76,6,0,0,82,CLASS
,/plugins/KLNF/:com.incors.plaf.kunststoff.themes.KunststoffPresentationTheme,78,6,0,0,84,CLASS
,/plugins/KLNF/:com.incors.plaf.kunststoff.themes.KunststoffDesktopTheme,45,6,0,0,51,CLASS
,/plugins/KLNF/:com.incors.plaf.kunststoff.KunststoffGradientTheme,23,3,0,0,26,CLASS
,/plugins/KLNF/:com.incors.plaf.kunststoff.KunststoffCheckBoxUI,13,4,0,0,17,CLASS
,/plugins/KLNF/:com.incors.plaf.kunststoff.ModifiedDefaultListCellRenderer,11,3,0,0,14,CLASS
,/plugins/KLNF/:com.incors.plaf.kunststoff.KunststoffMenuUI,27,5,0,0,32,CLASS
,/plugins/KLNF/:com.incors.plaf.kunststoff.KunststoffToggleButtonUI,57,5,0,0,62,CLASS
,/plugins/KLNF/:com.incors.plaf.kunststoff.KunststoffLookAndFeel,94,7,0,0,101,CLASS
,/plugins/KLNF/:com.incors.plaf.kunststoff.KunststoffTabbedPaneUI,65,5,0,0,70,CLASS
,/plugins/KLNF/:com.incors.plaf.kunststoff.KunststoffPasswordFieldUI,14,4,0,0,18,CLASS
,/plugins/KLNF/:com.incors.plaf.kunststoff.KunststoffButtonUI,57,5,0,0,62,CLASS
,/plugins/KLNF/:com.incors.plaf.kunststoff.KunststoffCheckBoxIcon,19,5,0,0,24,CLASS
,/plugins/KLNF/:com.incors.plaf.kunststoff.KunststoffToolBarUI,40,5,0,0,45,CLASS
,/plugins/KLNF/:com.incors.plaf.kunststoff.KunststoffScrollBarUI,32,5,0,0,37,CLASS
,/plugins/KLNF/:com.incors.plaf.kunststoff.KunststoffTheme,15,4,0,0,19,CLASS
,/plugins/KLNF/:com.incors.plaf.FastGradientPaint,15,4,0,0,19,CLASS
,/plugins/KLNF/:com.incors.plaf.ColorUIResource2,89,10,0,0,99,CLASS
,/plugins/KLNF/:com.incors.plaf.FastGradientPaintContext,41,10,0,68,119,CLASS
,/plugins/KLNF/:com.incors.plaf.FastGradientPaintContext$GradientInfo,17,0,0,0,17,INNER_CLASS
,/plugins/KLNF/:com.incors.plaf.FastGradientPaintContext$Gradient,51,0,0,0,51,INNER_CLASS
,/plugins/KLNF/JextKLNFTheme.java:default.JextKLNFTheme,15,5,0,0,20,CLASS
,/plugins/KLNF/KLNFOptionPane.java:default.KLNFOptionPane,14,4,0,0,18,CLASS
,/plugins/KLNF/KLNFPlugin.java:default.KLNFPlugin,42,7,0,0,49,CLASS
,/plugins/XMLBrowse/XMLBrowsePlugin.java:default.XMLBrowsePlugin,10,3,0,0,13,CLASS
,/plugins/HyperTyper/SequenceChangedEvent.java:default.SequenceChangedEvent,18,0,0,0,18,CLASS
,/plugins/HyperTyper/HyperTyperWindowGUI.java:default.HyperTyperWindowGUI,93,4,0,0,97,CLASS
,/plugins/HyperTyper/HyperTyperOption.java:default.HyperTyperOption,89,4,0,0,93,CLASS
,/plugins/HyperTyper/HyperTyperHotkey.java:default.HyperTyperHotkey,115,4,0,0,119,CLASS
,/plugins/HyperTyper/SequenceChangedListener.java:default.SequenceChangedListener,5,3,0,0,8,INTERFACE
,/plugins/HyperTyper/HyperTyperAction.java:default.HyperTyperAction,281,12,0,0,293,CLASS
,/plugins/HyperTyper/Sequence.java:default.Sequence,50,6,0,0,56,CLASS
,/plugins/HyperTyper/HyperTyperPlugin.java:default.HyperTyperPlugin,70,4,0,0,74,CLASS
,/plugins/HyperTyper/HyperTyperMappingGrid.java:default.HyperTyperMappingGrid,100,10,0,87,197,CLASS
,/plugins/HyperTyper/HyperTyperMappingGrid.java:default.HyperTyperMappingGrid$TyperTableModel,87,0,0,0,87,INNER_CLASS
,/plugins/HyperTyper/HyperTyperMapping.java:default.HyperTyperMapping,54,1,0,0,55,CLASS
,/plugins/HyperTyper/AutoExpander.java:default.AutoExpander,26,4,0,0,30,CLASS
,/plugins/HyperTyper/HyperTyperObjectManager.java:default.HyperTyperObjectManager,112,1,0,0,113,CLASS
,/plugins/HyperTyper/HyperTyperSequenceList.java:default.HyperTyperSequenceList,216,3,0,0,219,CLASS
,/plugins/FindAll/FindAllPlugin.java:default.FindAllPlugin,23,5,0,0,28,CLASS
,/plugins/FindAll/FindAll.java:default.FindAll,284,11,0,27,322,CLASS
,/plugins/FindAll/FindAll.java:default.FindAll$ListHandler,15,0,0,0,15,INNER_CLASS
,/plugins/FindAll/FindAll.java:default.FindAll$KeyHandler,12,0,0,0,12,INNER_CLASS
,/plugins/FindAll/FindAllAction.java:default.FindAllAction,17,4,0,0,21,CLASS
,/plugins/HTML/EntitiesListHandler.java:default.EntitiesListHandler,28,2,0,0,30,CLASS
,/plugins/HTML/TagsListHandler.java:default.TagsListHandler,40,2,0,0,42,CLASS
,/plugins/HTML/Entity.java:default.Entity,16,0,0,0,16,CLASS
,/plugins/HTML/TagsCompletion.java:default.TagsCompletion,222,9,0,0,231,CLASS
,/plugins/HTML/Tag.java:default.Tag,68,2,0,0,70,CLASS
,/plugins/HTML/EntitiesListReader.java:default.EntitiesListReader,30,3,0,0,33,CLASS
,/plugins/HTML/CompleteTagList.java:default.CompleteTagList,132,7,0,140,279,CLASS
,/plugins/HTML/CompleteTagList.java:default.CompleteTagList$KeyHandler,95,0,0,0,95,INNER_CLASS
,/plugins/HTML/CompleteTagList.java:default.CompleteTagList$MouseHandler,11,0,0,0,11,INNER_CLASS
,/plugins/HTML/CompleteTagList.java:default.CompleteTagList$TagsCellRenderer,34,0,0,0,34,INNER_CLASS
,/plugins/HTML/ToEntities.java:default.ToEntities,48,4,0,0,52,CLASS
,/plugins/HTML/HTMLIndenter.java:default.HTMLIndenter,154,5,0,0,159,CLASS
,/plugins/HTML/TagsListReader.java:default.TagsListReader,30,3,0,0,33,CLASS
,/plugins/HTML/Attribute.java:default.Attribute,18,0,0,0,18,CLASS
,/plugins/HTML/PreviousTag.java:default.PreviousTag,50,4,0,0,54,CLASS
,/plugins/HTML/ToAccents.java:default.ToAccents,84,5,0,0,89,CLASS
,/plugins/HTML/HTMLPlugin.java:default.HTMLPlugin,42,4,0,0,46,CLASS
,/plugins/HTML/NextTag.java:default.NextTag,53,4,0,0,57,CLASS
,/plugins/HTML/TagsCompletionOptionPane.java:default.TagsCompletionOptionPane,31,5,0,0,36,CLASS
,/plugins/HTML/IndenterOptionPane.java:default.IndenterOptionPane,19,4,0,0,23,CLASS
,/plugins/PyBrowse/PyBrowsePlugin.java:default.PyBrowsePlugin,10,3,0,0,13,CLASS
,/lib/:com.jgoodies.uif_lite.panel.SimpleInternalFrame,147,5,0,72,224,CLASS
,/lib/:com.jgoodies.uif_lite.panel.SimpleInternalFrame$RaisedHeaderBorder,14,0,0,0,14,INNER_CLASS
,/lib/:com.jgoodies.uif_lite.panel.SimpleInternalFrame$ShadowBorder,37,0,0,0,37,INNER_CLASS
,/lib/:com.jgoodies.uif_lite.panel.SimpleInternalFrame$GradientPanel,21,0,0,0,21,INNER_CLASS
,/lib/:com.jgoodies.uif_lite.component.Factory,21,9,0,0,30,CLASS
,/lib/:com.jgoodies.uif_lite.component.UIFSplitPane,63,9,0,0,72,CLASS
,/lib/:com.microstar.xml.HandlerBase,56,4,0,0,60,CLASS
,/lib/:com.microstar.xml.XmlHandler,28,1,0,0,29,INTERFACE
,/lib/:com.microstar.xml.XmlException,30,1,0,0,31,CLASS
,/lib/:com.microstar.xml.XmlParser,2373,10,0,0,2383,CLASS
,/lib/:org.gjt.sp.jedit.syntax.Token,37,1,0,0,38,CLASS
,/lib/:org.gjt.sp.jedit.syntax.EiffelTokenMarker,235,2,0,0,237,CLASS
,/lib/:org.gjt.sp.jedit.syntax.MakefileTokenMarker,138,2,0,0,140,CLASS
,/lib/:org.gjt.sp.jedit.syntax.JavaScriptTokenMarker,33,2,0,0,35,CLASS
,/lib/:org.gjt.sp.jedit.syntax.ShellScriptTokenMarker,242,2,0,0,244,CLASS
,/lib/:org.gjt.sp.jedit.syntax.TokenMarkerWithAddToken,4,1,0,0,5,INTERFACE
,/lib/:org.gjt.sp.jedit.syntax.CTokenMarker,272,2,0,0,274,CLASS
,/lib/:org.gjt.sp.jedit.syntax.BeanShellTokenMarker,47,2,0,0,49,CLASS
,/lib/:org.gjt.sp.jedit.syntax.LATTokenMarker,177,2,0,0,179,CLASS
,/lib/:org.gjt.sp.jedit.syntax.ASPVBScriptTokenMarker,416,2,0,0,418,CLASS
,/lib/:org.gjt.sp.jedit.syntax.CobolTokenMarker,760,2,0,0,762,CLASS
,/lib/:org.gjt.sp.jedit.syntax.MultiModeToken,41,1,0,0,42,CLASS
,/lib/:org.gjt.sp.jedit.syntax.ASPPerlscriptTokenMarker,731,2,0,0,733,CLASS
,/lib/:org.gjt.sp.jedit.syntax.MultiModeTokenMarkerWithContext,7,1,0,0,8,INTERFACE
,/lib/:org.gjt.sp.jedit.syntax.CCTokenMarker,91,2,0,0,93,CLASS
,/lib/:org.gjt.sp.jedit.syntax.ASPJavascriptTokenMarker,369,2,0,0,371,CLASS
,/lib/:org.gjt.sp.jedit.syntax.PropsTokenMarker,64,2,0,0,66,CLASS
,/lib/:org.gjt.sp.jedit.syntax.ASPStateInfo,53,5,0,0,58,CLASS
,/lib/:org.gjt.sp.jedit.syntax.ASPTokenMarker,389,0,0,0,389,CLASS
,/lib/:org.gjt.sp.jedit.syntax.TokenMarkerDebugger,27,1,0,0,28,CLASS
,/lib/:org.gjt.sp.jedit.syntax.PHPTokenMarker,490,2,0,0,492,CLASS
,/lib/:org.gjt.sp.jedit.syntax.PlainTokenMarker,9,2,0,0,11,CLASS
,/lib/:org.gjt.sp.jedit.syntax.TokenMarkerContext,156,3,0,0,159,CLASS
,/lib/:org.gjt.sp.jedit.syntax.PikeTokenMarker,53,2,0,0,55,CLASS
,/lib/:org.gjt.sp.jedit.syntax.HTMLTokenMarker,363,2,0,0,365,CLASS
,/lib/:org.gjt.sp.jedit.syntax.PascalTokenMarker,239,2,0,0,241,CLASS
,/lib/:org.gjt.sp.jedit.syntax.SyntaxStyle,73,3,0,0,76,CLASS
,/lib/:org.gjt.sp.jedit.syntax.IDLTokenMarker,53,2,0,0,55,CLASS
,/lib/:org.gjt.sp.jedit.syntax.KeywordMap,61,2,0,12,75,CLASS
,/lib/:org.gjt.sp.jedit.syntax.KeywordMap$Keyword,12,0,0,0,12,INNER_CLASS
,/lib/:org.gjt.sp.jedit.syntax.TextTokenMarker,82,2,0,0,84,CLASS
,/lib/:org.gjt.sp.jedit.syntax.PythonTokenMarker,260,2,0,0,262,CLASS
,/lib/:org.gjt.sp.jedit.syntax.ASMTokenMarker,896,2,0,0,898,CLASS
,/lib/:org.gjt.sp.jedit.syntax.FortranTokenMarker,250,2,0,0,252,CLASS
,/lib/:org.gjt.sp.jedit.syntax.TSQLTokenMarker,1069,2,0,0,1071,CLASS
,/lib/:org.gjt.sp.jedit.syntax.VHDLTokenMarker,274,2,0,0,276,CLASS
,/lib/:org.gjt.sp.jedit.syntax.CSharpTokenMarker,324,2,0,0,326,CLASS
,/lib/:org.gjt.sp.jedit.syntax.SAP2000TokenMarker,191,2,0,0,193,CLASS
,/lib/:org.gjt.sp.jedit.syntax.JavaTokenMarker,264,2,0,0,266,CLASS
,/lib/:org.gjt.sp.jedit.syntax.TeXTokenMarker,108,2,0,0,110,CLASS
,/lib/:org.gjt.sp.jedit.syntax.DawnTokenMarker,145,2,0,0,147,CLASS
,/lib/:org.gjt.sp.jedit.syntax.PovrayTokenMarker,188,2,0,0,190,CLASS
,/lib/:org.gjt.sp.jedit.syntax.JSPTokenMarker,591,2,0,0,593,CLASS
,/lib/:org.gjt.sp.jedit.syntax.SyntaxDocument,77,4,0,0,81,CLASS
,/lib/:org.gjt.sp.jedit.syntax.PatchTokenMarker,28,2,0,0,30,CLASS
,/lib/:org.gjt.sp.jedit.syntax.VerilogTokenMarker,325,2,0,0,327,CLASS
,/lib/:org.gjt.sp.jedit.syntax.PLSQLTokenMarker,337,2,0,0,339,CLASS
,/lib/:org.gjt.sp.jedit.syntax.RubyTokenMarker,203,2,0,0,205,CLASS
,/lib/:org.gjt.sp.jedit.syntax.TokenMarker,138,3,0,14,155,CLASS
,/lib/:org.gjt.sp.jedit.syntax.TokenMarker$LineInfo,14,0,0,0,14,INNER_CLASS
,/lib/:org.gjt.sp.jedit.syntax.ASPMode,17,1,0,0,18,CLASS
,/lib/:org.gjt.sp.jedit.syntax.SyntaxUtilities,92,3,0,0,95,CLASS
,/lib/:org.gjt.sp.jedit.syntax.BatchFileTokenMarker,90,2,0,0,92,CLASS
,/lib/:org.gjt.sp.jedit.syntax.SQRTokenMarker,259,2,0,0,261,CLASS
,/lib/:org.gjt.sp.jedit.gui.KeyEventWorkaround,140,4,0,0,144,CLASS
,/lib/:org.gjt.sp.jedit.textarea.TextAreaPainter,556,7,0,0,563,CLASS
,/lib/:org.gjt.sp.jedit.textarea.TextAreaDefaults,84,6,0,0,90,CLASS
,/lib/:org.gjt.sp.jedit.textarea.Gutter,269,24,0,63,356,CLASS
,/lib/:org.gjt.sp.jedit.textarea.Gutter$GutterMouseListener,63,0,0,0,63,INNER_CLASS
,/lib/:org.gjt.sp.jedit.textarea.TextUtilities,231,4,0,0,235,CLASS
,/lib/:org.gjt.sp.jedit.textarea.JEditTextArea,1082,15,0,505,1602,CLASS
,/lib/:org.gjt.sp.jedit.textarea.JEditTextArea$ScrollLayout,92,0,0,0,92,INNER_CLASS
,/lib/:org.gjt.sp.jedit.textarea.JEditTextArea$CaretBlinker,8,0,0,0,8,INNER_CLASS
,/lib/:org.gjt.sp.jedit.textarea.JEditTextArea$MutableCaretEvent,15,0,0,0,15,INNER_CLASS
,/lib/:org.gjt.sp.jedit.textarea.JEditTextArea$AdjustHandler,19,0,0,0,19,INNER_CLASS
,/lib/:org.gjt.sp.jedit.textarea.JEditTextArea$ComponentHandler,8,0,0,0,8,INNER_CLASS
,/lib/:org.gjt.sp.jedit.textarea.JEditTextArea$DocumentHandler,66,0,0,0,66,INNER_CLASS
,/lib/:org.gjt.sp.jedit.textarea.JEditTextArea$DragHandler,105,0,0,0,105,INNER_CLASS
,/lib/:org.gjt.sp.jedit.textarea.JEditTextArea$FocusHandler,13,0,0,0,13,INNER_CLASS
,/lib/:org.gjt.sp.jedit.textarea.JEditTextArea$MouseHandler,138,0,0,0,138,INNER_CLASS
,/lib/:org.gjt.sp.jedit.textarea.JEditTextArea$CaretUndo,41,0,0,0,41,INNER_CLASS
,/lib/:org.gjt.sp.jedit.textarea.InputHandler,229,7,0,598,834,CLASS
,/lib/:org.gjt.sp.jedit.textarea.InputHandler$NonRepeatable,1,0,0,0,1,INTERFACE
,/lib/:org.gjt.sp.jedit.textarea.InputHandler$NonRecordable,1,0,0,0,1,INTERFACE
,/lib/:org.gjt.sp.jedit.textarea.InputHandler$Wrapper,1,0,0,0,1,INTERFACE
,/lib/:org.gjt.sp.jedit.textarea.InputHandler$MacroRecorder,5,0,0,0,5,INTERFACE
,/lib/:org.gjt.sp.jedit.textarea.InputHandler$backspace,34,0,0,0,34,INNER_CLASS
,/lib/:org.gjt.sp.jedit.textarea.InputHandler$backspace_word,43,0,0,0,43,INNER_CLASS
,/lib/:org.gjt.sp.jedit.textarea.InputHandler$delete,34,0,0,0,34,INNER_CLASS
,/lib/:org.gjt.sp.jedit.textarea.InputHandler$delete_word,42,0,0,0,42,INNER_CLASS
,/lib/:org.gjt.sp.jedit.textarea.InputHandler$end,44,0,0,0,44,INNER_CLASS
,/lib/:org.gjt.sp.jedit.textarea.InputHandler$document_end,18,0,0,0,18,INNER_CLASS
,/lib/:org.gjt.sp.jedit.textarea.InputHandler$home,45,0,0,0,45,INNER_CLASS
,/lib/:org.gjt.sp.jedit.textarea.InputHandler$document_home,16,0,0,0,16,INNER_CLASS
,/lib/:org.gjt.sp.jedit.textarea.InputHandler$insert_break,13,0,0,0,13,INNER_CLASS
,/lib/:org.gjt.sp.jedit.textarea.InputHandler$insert_tab,13,0,0,0,13,INNER_CLASS
,/lib/:org.gjt.sp.jedit.textarea.InputHandler$next_char,23,0,0,0,23,INNER_CLASS
,/lib/:org.gjt.sp.jedit.textarea.InputHandler$next_line,32,0,0,0,32,INNER_CLASS
,/lib/:org.gjt.sp.jedit.textarea.InputHandler$next_page,27,0,0,0,27,INNER_CLASS
,/lib/:org.gjt.sp.jedit.textarea.InputHandler$next_word,44,0,0,0,44,INNER_CLASS
,/lib/:org.gjt.sp.jedit.textarea.InputHandler$overwrite,9,0,0,0,9,INNER_CLASS
,/lib/:org.gjt.sp.jedit.textarea.InputHandler$prev_char,23,0,0,0,23,INNER_CLASS
,/lib/:org.gjt.sp.jedit.textarea.InputHandler$prev_line,32,0,0,0,32,INNER_CLASS
,/lib/:org.gjt.sp.jedit.textarea.InputHandler$prev_page,24,0,0,0,24,INNER_CLASS
,/lib/:org.gjt.sp.jedit.textarea.InputHandler$prev_word,42,0,0,0,42,INNER_CLASS
,/lib/:org.gjt.sp.jedit.textarea.InputHandler$repeat,14,0,0,0,14,INNER_CLASS
,/lib/:org.gjt.sp.jedit.textarea.InputHandler$insert_char,18,0,0,0,18,INNER_CLASS
,/lib/:org.gjt.sp.jedit.textarea.TextAreaHighlight,6,3,0,0,9,INTERFACE
,/lib/:org.gjt.sp.jedit.textarea.DefaultInputHandler,253,7,0,0,260,CLASS
,/lib/:org.gjt.sp.jedit.OperatingSystem,81,3,0,0,84,CLASS
,/lib/:org.jext.gui.JextLabeledMenuSeparatorUI,42,10,0,0,52,CLASS
,/lib/:org.jext.gui.AbstractOptionPane,56,4,0,0,60,CLASS
,/lib/:org.jext.gui.VoidComponent,40,4,0,0,44,CLASS
,/lib/:org.jext.gui.SplashScreen,103,9,0,0,112,CLASS
,/lib/:org.jext.gui.SkinManager,51,3,0,0,54,CLASS
,/lib/:org.jext.gui.SkinFactory,4,1,0,0,5,INTERFACE
,/lib/:org.jext.gui.GenericSkin,42,3,0,0,45,CLASS
,/lib/:org.jext.gui.DisabledCellRenderer,17,5,0,0,22,CLASS
,/lib/:org.jext.gui.PlasticSettings,159,11,0,0,170,CLASS
,/lib/:org.jext.gui.JextMenuSeparatorUI,19,8,0,0,27,CLASS
,/lib/:org.jext.gui.Skin,11,1,0,0,12,CLASS
,/lib/:org.jext.gui.JextHighlightButton,52,7,0,14,73,CLASS
,/lib/:org.jext.gui.JextHighlightButton$MouseHandler,14,0,0,0,14,INNER_CLASS
,/lib/:org.jext.gui.JextMenu,33,6,0,0,39,CLASS
,/lib/:org.jext.gui.JextButton,107,17,0,23,147,CLASS
,/lib/:org.jext.gui.JextButton$MouseHandler,23,0,0,0,23,INNER_CLASS
,/lib/:org.jext.gui.FontSelector,77,7,0,148,232,CLASS
,/lib/:org.jext.gui.FontSelector$SelectorFrame,148,0,0,0,148,INNER_CLASS
,/lib/:org.jext.gui.JextLabeledMenuSeparator,32,3,0,0,35,CLASS
,/lib/:org.jext.gui.JextMetalTheme,45,5,0,0,50,CLASS
,/lib/:org.jext.gui.JextToggleButton,53,7,0,13,73,CLASS
,/lib/:org.jext.gui.JextToggleButton$MouseHandler,13,0,0,0,13,INNER_CLASS
,/lib/:org.jext.gui.BundledSkinFactory,37,7,0,60,104,CLASS
,/lib/:org.jext.gui.BundledSkinFactory$MetalSkin,13,0,0,0,13,INNER_CLASS
,/lib/:org.jext.gui.BundledSkinFactory$JextSkin,13,0,0,0,13,INNER_CLASS
,/lib/:org.jext.gui.BundledSkinFactory$PlasticSkin,34,0,0,0,34,INNER_CLASS
,/lib/:org.jext.gui.OptionGroup,58,3,0,0,61,CLASS
,/lib/:org.jext.gui.AbstractDisposer,23,4,0,0,27,CLASS
,/lib/:org.jext.gui.JextSeparator,17,3,0,0,20,CLASS
,/lib/:org.jext.gui.JextProgressBarUI,39,11,0,0,50,CLASS
,/lib/:org.jext.gui.EnhancedMenuItem,72,5,0,0,77,CLASS
,/lib/:org.jext.gui.JextMenuSeparator,17,3,0,0,20,CLASS
,/lib/:org.jext.gui.ModifiedCellRenderer,13,3,0,0,16,CLASS
,/lib/:org.jext.gui.OptionPane,8,2,0,0,10,INTERFACE
,/lib/:org.jext.gui.JextSeparatorUI,21,7,0,0,28,CLASS
,/lib/:org.jext.gui.Dockable,105,4,0,0,109,CLASS
,/lib/:org.jext.gui.DockChangeHandler,3,1,0,0,4,INTERFACE
,/lib/:org.jext.gui.JextProgressBar,33,3,0,0,36,CLASS
,/lib/:org.jext.gui.JextCheckBox,11,2,0,0,13,CLASS
,/lib/:org.jext.ModeFileFilter,55,5,0,0,60,CLASS
,/lib/:org.jext.Jext,900,26,0,0,926,CLASS
,/lib/:org.jext.JextLoader,125,5,0,0,130,CLASS
,/lib/:org.jext.xml.XBarReader,26,4,0,0,30,CLASS
,/lib/:org.jext.xml.OneClickActionsReader,34,4,0,0,38,CLASS
,/lib/:org.jext.xml.XPropertiesReader,43,4,0,0,47,CLASS
,/lib/:org.jext.xml.XBarHandler,90,7,0,0,97,CLASS
,/lib/:org.jext.xml.XInsertHandler,79,4,0,0,83,CLASS
,/lib/:org.jext.xml.OneClickActionsHandler,30,3,0,0,33,CLASS
,/lib/:org.jext.xml.XMenuHandler,137,7,0,0,144,CLASS
,/lib/:org.jext.xml.PyActionsReader,34,4,0,0,38,CLASS
,/lib/:org.jext.xml.XInsertReader,30,5,0,0,35,CLASS
,/lib/:org.jext.xml.XPropertiesHandler,80,4,0,0,84,CLASS
,/lib/:org.jext.xml.XMenuReader,26,4,0,0,30,CLASS
,/lib/:org.jext.xml.XPopupHandler,102,6,0,0,108,CLASS
,/lib/:org.jext.xml.PyActionsHandler,35,3,0,0,38,CLASS
,/lib/:org.jext.xml.XPopupReader,30,5,0,0,35,CLASS
,/lib/:org.jext.actions.JoinAllLines,22,6,0,0,28,CLASS
,/lib/:org.jext.actions.BoxComment,48,6,0,0,54,CLASS
,/lib/:org.jext.actions.CompleteWordAll,108,10,0,0,118,CLASS
,/lib/:org.jext.actions.JoinLines,33,6,0,0,39,CLASS
,/lib/:org.jext.actions.Print,46,6,0,0,52,CLASS
,/lib/:org.jext.actions.ToUpperCase,37,6,0,0,43,CLASS
,/lib/:org.jext.actions.WingComment,25,4,0,0,29,CLASS
,/lib/:org.jext.actions.RemoveWhitespace,43,6,0,0,49,CLASS
,/lib/:org.jext.actions.SimpleComment,40,5,0,0,45,CLASS
,/lib/:org.jext.actions.SimpleUnComment,58,5,0,0,63,CLASS
,/lib/:org.jext.actions.CompleteWord,103,10,0,0,113,CLASS
,/lib/:org.jext.actions.LeftIndent,37,6,0,0,43,CLASS
,/lib/:org.jext.actions.ToLowerCase,37,6,0,0,43,CLASS
,/lib/:org.jext.actions.RightIndent,35,6,0,0,41,CLASS
,/lib/:org.jext.actions.OpenUrl,32,6,0,0,38,CLASS
,/lib/:org.jext.actions.BeginLine,36,7,0,0,43,CLASS
,/lib/:org.jext.actions.CreateTemplate,79,15,0,0,94,CLASS
,/lib/:org.jext.actions.SpacesToTabs,75,6,0,0,81,CLASS
,/lib/:org.jext.actions.EndLine,36,7,0,0,43,CLASS
,/lib/:org.jext.actions.WordCount,76,6,0,0,82,CLASS
,/lib/:org.jext.actions.TabsToSpaces,56,6,0,0,62,CLASS
,/lib/:org.jext.Mode,48,3,0,0,51,CLASS
,/lib/:org.jext.Utilities,521,11,0,0,532,CLASS
,/lib/:org.jext.MenuAction,68,7,0,0,75,CLASS
,/lib/:org.jext.misc.DownloaderThread,28,3,0,0,31,CLASS
,/lib/:org.jext.misc.AboutWindow,39,7,0,0,46,CLASS
,/lib/:org.jext.misc.StringSorter,43,6,0,0,49,CLASS
,/lib/:org.jext.misc.AboutPlugins,67,8,0,18,93,CLASS
,/lib/:org.jext.misc.AboutPlugins$InstalledPlugin,18,0,0,0,18,INNER_CLASS
,/lib/:org.jext.misc.SaveDialog,159,11,0,39,209,CLASS
,/lib/:org.jext.misc.SaveDialog$WorkspaceLabel,13,0,0,0,13,INNER_CLASS
,/lib/:org.jext.misc.SaveDialog$DirtyArea,26,0,0,0,26,INNER_CLASS
,/lib/:org.jext.misc.AutoSave,46,3,0,0,49,CLASS
,/lib/:org.jext.misc.CompleteWordList,78,8,0,84,170,CLASS
,/lib/:org.jext.misc.CompleteWordList$KeyHandler,76,0,0,0,76,INNER_CLASS
,/lib/:org.jext.misc.CompleteWordList$MouseHandler,8,0,0,0,8,INNER_CLASS
,/lib/:org.jext.misc.VirtualFolders,466,14,0,142,622,CLASS
,/lib/:org.jext.misc.VirtualFolders$MouseHandler,16,0,0,0,16,INNER_CLASS
,/lib/:org.jext.misc.VirtualFolders$VirtualFoldersHandler,39,0,0,0,39,INNER_CLASS
,/lib/:org.jext.misc.VirtualFolders$VirtualFolderNode,41,0,0,0,41,INNER_CLASS
,/lib/:org.jext.misc.VirtualFolders$KeyHandler,8,0,0,0,8,INNER_CLASS
,/lib/:org.jext.misc.VirtualFolders$DnDHandler,38,0,0,0,38,INNER_CLASS
,/lib/:org.jext.misc.TabSwitcher,22,4,0,0,26,CLASS
,/lib/:org.jext.misc.JextMail,289,14,0,0,303,CLASS
,/lib/:org.jext.misc.PluginAuthor,18,1,0,0,19,CLASS
,/lib/:org.jext.misc.PluginDownload,208,17,0,7,232,CLASS
,/lib/:org.jext.misc.PluginDownload$WaitDialog,7,0,0,0,7,INNER_CLASS
,/lib/:org.jext.misc.ZipExplorer,126,11,0,77,214,CLASS
,/lib/:org.jext.misc.ZipExplorer$ZipTableModel,77,0,0,0,77,INNER_CLASS
,/lib/:org.jext.misc.VersionCheck,54,7,0,0,61,CLASS
,/lib/:org.jext.misc.WorkspaceSwitcher,39,16,0,28,83,CLASS
,/lib/:org.jext.misc.WorkspaceSwitcher$Switcher,28,0,0,0,28,INNER_CLASS
,/lib/:org.jext.misc.HandlingRunnable,3,1,0,0,4,INTERFACE
,/lib/:org.jext.misc.AbstractPlugReader,5,2,0,0,7,INTERFACE
,/lib/:org.jext.misc.CopyThread,29,2,0,0,31,CLASS
,/lib/:org.jext.misc.SwingWorker,77,2,0,6,85,CLASS
,/lib/:org.jext.misc.SwingWorker$ThreadVar,6,0,0,0,6,INNER_CLASS
,/lib/:org.jext.misc.Workspaces,314,13,0,125,452,CLASS
,/lib/:org.jext.misc.Workspaces$WorkspacesHandler,60,0,0,0,60,INNER_CLASS
,/lib/:org.jext.misc.Workspaces$WorkspaceElement,29,0,0,0,29,INNER_CLASS
,/lib/:org.jext.misc.Workspaces$DnDHandler,36,0,0,0,36,INNER_CLASS
,/lib/:org.jext.misc.PluginDesc,207,8,0,0,215,CLASS
,/lib/:org.jext.misc.ProjectPanel,29,7,0,11,47,CLASS
,/lib/:org.jext.misc.ProjectPanel$ToggleHandler,11,0,0,0,11,INNER_CLASS
,/lib/:org.jext.misc.Indent,152,7,0,0,159,CLASS
,/lib/:org.jext.misc.FindAccessory,219,13,0,180,412,CLASS
,/lib/:org.jext.misc.FindAccessory$FindAction,11,0,0,0,11,INNER_CLASS
,/lib/:org.jext.misc.FindAccessory$FindControls,25,0,0,0,25,INNER_CLASS
,/lib/:org.jext.misc.FindAccessory$FindTabs,58,0,0,0,58,INNER_CLASS
,/lib/:org.jext.misc.FindAccessory$FindResults,51,0,0,35,86,INNER_CLASS
,/lib/:org.jext.misc.FindAccessory$FindResults$FindResultsCellRenderer,35,0,0,0,35,INNER_CLASS
,/lib/:org.jext.misc.FindFilter,4,0,0,0,4,INTERFACE
,/lib/:org.jext.misc.FindProgressCallback,5,0,0,0,5,INTERFACE
,/lib/:org.jext.misc.FindFilterFactory,4,0,0,0,4,INTERFACE
,/lib/:org.jext.misc.FindByDate,117,0,0,27,144,CLASS
,/lib/:org.jext.misc.FindByDate$DateFilter,27,0,0,0,27,INNER_CLASS
,/lib/:org.jext.misc.FindByName,40,0,0,95,135,CLASS
,/lib/:org.jext.misc.FindByName$NameFilter,95,0,0,0,95,INNER_CLASS
,/lib/:org.jext.JextTextArea,985,27,0,41,1053,CLASS
,/lib/:org.jext.JextTextArea$FocusHandler,16,0,0,0,16,INNER_CLASS
,/lib/:org.jext.JextTextArea$CaretHandler,7,0,0,0,7,INNER_CLASS
,/lib/:org.jext.JextTextArea$JextTextAreaPopupMenu,18,0,0,0,18,INNER_CLASS
,/lib/:org.jext.PythonEditAction,7,4,0,0,11,CLASS
,/lib/:org.jext.JavaSupport,22,4,0,28,54,CLASS
,/lib/:org.jext.JavaSupport$JextKeyboardFocusManager,28,0,0,0,28,INNER_CLASS
,/lib/:org.jext.JARClassLoader,350,7,0,0,357,CLASS
,/lib/:org.jext.print.PrintingOptions,78,4,0,0,82,CLASS
,/lib/:org.jext.print.PrintSyntax,118,7,0,15,140,CLASS
,/lib/:org.jext.print.PrintSyntax$PrintTabExpander,15,0,0,0,15,INNER_CLASS
,/lib/:org.jext.print.PrintText,264,8,0,91,363,CLASS
,/lib/:org.jext.print.PrintText$Page,52,0,0,0,52,INNER_CLASS
,/lib/:org.jext.print.PrintText$PrintableText,39,0,0,0,39,INNER_CLASS
,/lib/:org.jext.protocol.jextresource.PluginResURLConnection,44,5,0,0,49,CLASS
,/lib/:org.jext.protocol.jextresource.Handler,9,3,0,0,12,CLASS
,/lib/:org.jext.options.LoadingOptions,37,6,0,0,43,CLASS
,/lib/:org.jext.options.PrintOptions,88,8,0,0,96,CLASS
,/lib/:org.jext.options.LangOptions,43,6,0,0,49,CLASS
,/lib/:org.jext.options.FileFiltersOptions,38,7,0,88,133,CLASS
,/lib/:org.jext.options.FileFiltersOptions$FiltersTableModel,62,0,0,0,62,INNER_CLASS
,/lib/:org.jext.options.FileFiltersOptions$FileFilter,26,0,0,0,26,INNER_CLASS
,/lib/:org.jext.options.GeneralOptions,106,8,0,0,114,CLASS
,/lib/:org.jext.options.GutterOptions,66,5,0,0,71,CLASS
,/lib/:org.jext.options.KeyShortcutsOptions,91,8,0,92,191,CLASS
,/lib/:org.jext.options.KeyShortcutsOptions$KeysTableModel,92,0,0,0,92,INNER_CLASS
,/lib/:org.jext.options.SecurityOptions,28,6,0,0,34,CLASS
,/lib/:org.jext.options.ColorTable,16,18,0,139,173,CLASS
,/lib/:org.jext.options.ColorTable$ListHandler,14,0,0,0,14,INNER_CLASS
,/lib/:org.jext.options.ColorTable$ColorTableModel,78,0,0,47,125,INNER_CLASS
,/lib/:org.jext.options.ColorTable$ColorTableModel$ColorChoice,16,0,0,0,16,INNER_CLASS
,/lib/:org.jext.options.ColorTable$ColorTableModel$ColorRenderer,31,0,0,0,31,INNER_CLASS
,/lib/:org.jext.options.EditorOptions,145,5,0,0,150,CLASS
,/lib/:org.jext.options.OptionsDialog,304,10,0,183,497,CLASS
,/lib/:org.jext.options.OptionsDialog$MouseHandler,18,0,0,0,18,INNER_CLASS
,/lib/:org.jext.options.OptionsDialog$PaneNameRenderer,50,0,0,0,50,INNER_CLASS
,/lib/:org.jext.options.OptionsDialog$OptionTreeModel,115,0,0,0,115,INNER_CLASS
,/lib/:org.jext.options.UIOptions,127,10,0,21,158,CLASS
,/lib/:org.jext.options.UIOptions$SkinItem,21,0,0,0,21,INNER_CLASS
,/lib/:org.jext.options.StyleTable,16,31,0,226,273,CLASS
,/lib/:org.jext.options.StyleTable$ListHandler,13,0,0,0,13,INNER_CLASS
,/lib/:org.jext.options.StyleTable$StyleTableModel,78,0,0,50,128,INNER_CLASS
,/lib/:org.jext.options.StyleTable$StyleTableModel$StyleChoice,16,0,0,0,16,INNER_CLASS
,/lib/:org.jext.options.StyleTable$StyleTableModel$StyleRenderer,34,0,0,0,34,INNER_CLASS
,/lib/:org.jext.options.StyleTable$StyleEditor,85,0,0,0,85,INNER_CLASS
,/lib/:org.jext.options.StylesOptions,98,10,0,0,108,CLASS
,/lib/:org.jext.JextTabbedPane,141,15,0,44,200,CLASS
,/lib/:org.jext.JextTabbedPane$PopupMenu,44,0,0,0,44,INNER_CLASS
,/lib/:org.jext.textarea.ScrollUp,13,5,0,0,18,CLASS
,/lib/:org.jext.textarea.IndentOnTab,48,9,0,0,57,CLASS
,/lib/:org.jext.textarea.ScrollPageDown,15,5,0,0,20,CLASS
,/lib/:org.jext.textarea.CsWord,116,7,0,0,123,CLASS
,/lib/:org.jext.textarea.PrevLineIndent,37,6,0,0,43,CLASS
,/lib/:org.jext.textarea.IndentOnEnter,16,6,0,0,22,CLASS
,/lib/:org.jext.textarea.ScrollPageUp,15,5,0,0,20,CLASS
,/lib/:org.jext.textarea.ScrollDown,13,4,0,0,17,CLASS
,/lib/:org.jext.textarea.NextLineIndent,37,6,0,0,43,CLASS
,/lib/:org.jext.RegisterablePlugin,4,1,0,0,5,INTERFACE
,/lib/:org.jext.event.JextEvent,46,3,0,0,49,CLASS
,/lib/:org.jext.event.JextListener,4,1,0,0,5,INTERFACE
,/lib/:org.jext.GUIUtilities,265,18,0,0,283,CLASS
,/lib/:org.jext.PythonAction,24,4,0,0,28,CLASS
,/lib/:org.jext.console.Console,588,14,0,300,902,CLASS
,/lib/:org.jext.console.Console$Appender,23,0,0,0,23,INNER_CLASS
,/lib/:org.jext.console.Console$ConsoleProcess,120,0,0,157,277,INNER_CLASS
,/lib/:org.jext.console.Console$ConsoleProcess$StdinThread,70,0,0,0,70,INNER_CLASS
,/lib/:org.jext.console.Console$ConsoleProcess$StdoutThread,66,0,0,0,66,INNER_CLASS
,/lib/:org.jext.console.Console$ConsoleProcess$StderrThread,21,0,0,0,21,INNER_CLASS
,/lib/:org.jext.console.HistoryModel,32,2,0,0,34,CLASS
,/lib/:org.jext.console.commands.HttpCommand,35,8,0,0,43,CLASS
,/lib/:org.jext.console.commands.EvalCommand,33,7,0,0,40,CLASS
,/lib/:org.jext.console.commands.RunCommand,26,5,0,0,31,CLASS
,/lib/:org.jext.console.commands.ClearCommand,24,4,0,0,28,CLASS
,/lib/:org.jext.console.commands.ChangeDirCommand,28,5,0,0,33,CLASS
,/lib/:org.jext.console.commands.ExitCommand,21,3,0,0,24,CLASS
,/lib/:org.jext.console.commands.HomeCommand,21,3,0,0,24,CLASS
,/lib/:org.jext.console.commands.FileCommand,25,4,0,0,29,CLASS
,/lib/:org.jext.console.commands.HelpCommand,21,3,0,0,24,CLASS
,/lib/:org.jext.console.commands.Command,7,2,0,0,9,CLASS
,/lib/:org.jext.console.commands.ListCommand,25,4,0,0,29,CLASS
,/lib/:org.jext.console.commands.JythonCommand,25,3,0,0,28,CLASS
,/lib/:org.jext.console.commands.PwdCommand,21,4,0,0,25,CLASS
,/lib/:org.jext.console.ConsoleTextPane,14,10,0,129,153,CLASS
,/lib/:org.jext.console.ConsoleTextPane$ConsoleKeyAdapter,96,0,0,0,96,INNER_CLASS
,/lib/:org.jext.console.ConsoleTextPane$DnDHandler,33,0,0,0,33,INNER_CLASS
,/lib/:org.jext.console.ConsoleListDir,240,8,0,0,248,CLASS
,/lib/:org.jext.OneClickAction,22,2,0,0,24,CLASS
,/lib/:org.jext.toolbar.FastSyntax,54,7,0,0,61,CLASS
,/lib/:org.jext.toolbar.FastFind,61,6,0,0,67,CLASS
,/lib/:org.jext.toolbar.JextToolBar,87,14,0,0,101,CLASS
,/lib/:org.jext.search.Search,167,5,0,0,172,CLASS
,/lib/:org.jext.search.BoyerMooreSearchMatcher,139,3,0,0,142,CLASS
,/lib/:org.jext.search.SearchHighlight,68,7,0,0,75,CLASS
,/lib/:org.jext.search.LiteralSearchMatcher,137,1,0,0,138,CLASS
,/lib/:org.jext.search.FindAllDialog,230,10,0,25,265,CLASS
,/lib/:org.jext.search.FindAllDialog$ListHandler,11,0,0,0,11,INNER_CLASS
,/lib/:org.jext.search.FindAllDialog$KeyHandler,14,0,0,0,14,INNER_CLASS
,/lib/:org.jext.search.SearchResult,42,4,0,0,46,CLASS
,/lib/:org.jext.search.RESearchMatcher,45,4,0,0,49,CLASS
,/lib/:org.jext.search.FindReplace,428,7,0,17,452,CLASS
,/lib/:org.jext.search.FindReplace$KeyHandler,17,0,0,0,17,INNER_CLASS
,/lib/:org.jext.search.SearchMatcher,5,2,0,0,7,INTERFACE
,/lib/:org.jext.dawn.javaccess.InvokeFunction,71,3,0,0,74,CLASS
,/lib/:org.jext.dawn.javaccess.ConstructorFunction,43,3,0,0,46,CLASS
,/lib/:org.jext.dawn.javaccess.ClassFunction,20,2,0,0,22,CLASS
,/lib/:org.jext.dawn.javaccess.NullFunction,15,3,0,0,18,CLASS
,/lib/:org.jext.dawn.javaccess.FieldFunction,27,3,0,0,30,CLASS
,/lib/:org.jext.dawn.javaccess.MethodFunction,43,3,0,0,46,CLASS
,/lib/:org.jext.dawn.javaccess.NewFunction,94,3,0,0,97,CLASS
,/lib/:org.jext.dawn.DawnUtilities,82,2,0,0,84,CLASS
,/lib/:org.jext.dawn.loop.DoLoopFunction,91,4,0,0,95,CLASS
,/lib/:org.jext.dawn.loop.ForFunction,87,4,0,0,91,CLASS
,/lib/:org.jext.dawn.loop.WhileFunction,89,4,0,0,93,CLASS
,/lib/:org.jext.dawn.array.SetElementAtFunction,19,2,0,0,21,CLASS
,/lib/:org.jext.dawn.array.ElementsFunction,17,3,0,0,20,CLASS
,/lib/:org.jext.dawn.array.ElementAtFunction,18,2,0,0,20,CLASS
,/lib/:org.jext.dawn.array.LengthFunction,12,2,0,0,14,CLASS
,/lib/:org.jext.dawn.array.ClearArrayFunction,12,2,0,0,14,CLASS
,/lib/:org.jext.dawn.array.AddElementFunction,13,2,0,0,15,CLASS
,/lib/:org.jext.dawn.array.RemoveElementAtFunction,18,2,0,0,20,CLASS
,/lib/:org.jext.dawn.array.InsertElementAtFunction,19,2,0,0,21,CLASS
,/lib/:org.jext.dawn.array.ArrayFunction,11,2,0,0,13,CLASS
,/lib/:org.jext.dawn.naming.CreateFunction,53,3,0,0,56,CLASS
,/lib/:org.jext.dawn.naming.CreateGlobalFunction,53,3,0,0,56,CLASS
,/lib/:org.jext.dawn.naming.FromLiteralFunction,14,2,0,0,16,CLASS
,/lib/:org.jext.dawn.naming.ToLiteralFunction,14,2,0,0,16,CLASS
,/lib/:org.jext.dawn.util.ExitFunction,11,2,0,0,13,CLASS
,/lib/:org.jext.dawn.util.DateFunction,11,2,0,0,13,CLASS
,/lib/:org.jext.dawn.util.RdzFunction,11,2,0,0,13,CLASS
,/lib/:org.jext.dawn.util.RandomizeFunction,11,2,0,0,13,CLASS
,/lib/:org.jext.dawn.util.FormattedDateFunction,12,4,0,0,16,CLASS
,/lib/:org.jext.dawn.util.ConstructPathFunction,14,2,0,0,16,CLASS
,/lib/:org.jext.dawn.util.ScriptExecFunction,28,6,0,0,34,CLASS
,/lib/:org.jext.dawn.util.HelpFunction,22,4,0,0,26,CLASS
,/lib/:org.jext.dawn.util.DumpFunction,11,3,0,0,14,CLASS
,/lib/:org.jext.dawn.util.RandomFunction,12,3,0,0,15,CLASS
,/lib/:org.jext.dawn.util.TimeFunction,11,2,0,0,13,CLASS
,/lib/:org.jext.dawn.util.WaitFunction,15,2,0,0,17,CLASS
,/lib/:org.jext.dawn.util.ExecFunction,21,3,0,0,24,CLASS
,/lib/:org.jext.dawn.util.VersionFunction,11,2,0,0,13,CLASS
,/lib/:org.jext.dawn.util.EvalFunction,20,6,0,0,26,CLASS
,/lib/:org.jext.dawn.Function,23,1,0,0,24,CLASS
,/lib/:org.jext.dawn.err.ErrorFunction,13,2,0,0,15,CLASS
,/lib/:org.jext.dawn.err.ErrManager,11,2,0,0,13,CLASS
,/lib/:org.jext.dawn.err.ErrMsgFunction,15,2,0,0,17,CLASS
,/lib/:org.jext.dawn.err.TryCatchFunction,87,4,0,0,91,CLASS
,/lib/:org.jext.dawn.CodeSnippet,9,1,0,0,10,CLASS
,/lib/:org.jext.dawn.Dawn,86,5,0,0,91,CLASS
,/lib/:org.jext.dawn.DawnParser,578,6,0,0,584,CLASS
,/lib/:org.jext.dawn.string.HeadFunction,14,2,0,0,16,CLASS
,/lib/:org.jext.dawn.string.NumFunction,16,2,0,0,18,CLASS
,/lib/:org.jext.dawn.string.FromStringFunction,16,2,0,0,18,CLASS
,/lib/:org.jext.dawn.string.TokenizeDelimFunction,16,2,0,0,18,CLASS
,/lib/:org.jext.dawn.string.TrimFunction,12,2,0,0,14,CLASS
,/lib/:org.jext.dawn.string.ChrFunction,12,2,0,0,14,CLASS
,/lib/:org.jext.dawn.string.EndsWithFunction,14,2,0,0,16,CLASS
,/lib/:org.jext.dawn.string.TokenizeFunction,16,2,0,0,18,CLASS
,/lib/:org.jext.dawn.string.UpperCaseFunction,12,2,0,0,14,CLASS
,/lib/:org.jext.dawn.string.SizeFunction,12,2,0,0,14,CLASS
,/lib/:org.jext.dawn.string.ToStringFunction,12,2,0,0,14,CLASS
,/lib/:org.jext.dawn.string.PosFunction,14,2,0,0,16,CLASS
,/lib/:org.jext.dawn.string.ConcatFunction,13,2,0,0,15,CLASS
,/lib/:org.jext.dawn.string.SubFunction,21,2,0,0,23,CLASS
,/lib/:org.jext.dawn.string.TailFunction,14,2,0,0,16,CLASS
,/lib/:org.jext.dawn.string.LastPosFunction,14,2,0,0,16,CLASS
,/lib/:org.jext.dawn.string.LowerCaseFunction,12,2,0,0,14,CLASS
,/lib/:org.jext.dawn.string.TokenizeArrayFunction,11,2,0,0,13,CLASS
,/lib/:org.jext.dawn.string.CharAtFunction,16,2,0,0,18,CLASS
,/lib/:org.jext.dawn.string.StartsWithFunction,14,2,0,0,16,CLASS
,/lib/:org.jext.dawn.io.ReadFunction,14,2,0,0,16,CLASS
,/lib/:org.jext.dawn.io.PrintFunction,12,2,0,0,14,CLASS
,/lib/:org.jext.dawn.io.CloseFileFunction,12,2,0,0,14,CLASS
,/lib/:org.jext.dawn.io.WriteLineFunction,12,2,0,0,14,CLASS
,/lib/:org.jext.dawn.io.FileManager,128,3,0,0,131,CLASS
,/lib/:org.jext.dawn.io.FileSizeFunction,12,3,0,0,15,CLASS
,/lib/:org.jext.dawn.io.PrintlnFunction,12,2,0,0,14,CLASS
,/lib/:org.jext.dawn.io.ExistFunction,12,3,0,0,15,CLASS
,/lib/:org.jext.dawn.io.ReadLineFunction,14,2,0,0,16,CLASS
,/lib/:org.jext.dawn.io.InputLineFunction,19,3,0,0,22,CLASS
,/lib/:org.jext.dawn.io.OpenInputFunction,12,2,0,0,14,CLASS
,/lib/:org.jext.dawn.io.OpenOutputFunction,12,2,0,0,14,CLASS
,/lib/:org.jext.dawn.io.LineSeparatorFunction,11,2,0,0,13,CLASS
,/lib/:org.jext.dawn.io.WriteFunction,12,2,0,0,14,CLASS
,/lib/:org.jext.dawn.io.IsAvailableFunction,12,2,0,0,14,CLASS
,/lib/:org.jext.dawn.stack.RclFunction,30,3,0,0,33,CLASS
,/lib/:org.jext.dawn.stack.DupDupFunction,11,2,0,0,13,CLASS
,/lib/:org.jext.dawn.stack.UnrotFunction,11,2,0,0,13,CLASS
,/lib/:org.jext.dawn.stack.StoFunction,14,2,0,0,16,CLASS
,/lib/:org.jext.dawn.stack.RotFunction,11,2,0,0,13,CLASS
,/lib/:org.jext.dawn.stack.RollFunction,22,3,0,0,25,CLASS
,/lib/:org.jext.dawn.stack.DepthFunction,11,2,0,0,13,CLASS
,/lib/:org.jext.dawn.stack.DupnFunction,16,3,0,0,19,CLASS
,/lib/:org.jext.dawn.stack.DupFunction,12,2,0,0,14,CLASS
,/lib/:org.jext.dawn.stack.DropnFunction,15,2,0,0,17,CLASS
,/lib/:org.jext.dawn.stack.RollDownFunction,22,3,0,0,25,CLASS
,/lib/:org.jext.dawn.stack.ClearFunction,11,2,0,0,13,CLASS
,/lib/:org.jext.dawn.stack.NDupFunction,14,2,0,0,16,CLASS
,/lib/:org.jext.dawn.stack.SwapFunction,15,2,0,0,17,CLASS
,/lib/:org.jext.dawn.stack.SetFunction,14,2,0,0,16,CLASS
,/lib/:org.jext.dawn.stack.ReverseFunction,18,3,0,0,21,CLASS
,/lib/:org.jext.dawn.stack.PickFunction,15,3,0,0,18,CLASS
,/lib/:org.jext.dawn.stack.DropFunction,12,2,0,0,14,CLASS
,/lib/:org.jext.dawn.DawnRuntimeException,11,1,0,0,12,CLASS
,/lib/:org.jext.dawn.math.FactFunction,18,2,0,0,20,CLASS
,/lib/:org.jext.dawn.math.PowerFunction,14,2,0,0,16,CLASS
,/lib/:org.jext.dawn.math.CosFunction,11,2,0,0,13,CLASS
,/lib/:org.jext.dawn.math.IncreaseFunction,25,2,0,0,27,CLASS
,/lib/:org.jext.dawn.math.DecreaseFunction,25,2,0,0,27,CLASS
,/lib/:org.jext.dawn.math.SqrtFunction,12,2,0,0,14,CLASS
,/lib/:org.jext.dawn.math.ArcSinFunction,11,2,0,0,13,CLASS
,/lib/:org.jext.dawn.math.PiFunction,11,2,0,0,13,CLASS
,/lib/:org.jext.dawn.math.InvertFunction,11,2,0,0,13,CLASS
,/lib/:org.jext.dawn.math.ModuloFunction,14,2,0,0,16,CLASS
,/lib/:org.jext.dawn.math.TanFunction,11,2,0,0,13,CLASS
,/lib/:org.jext.dawn.math.RoundFunction,11,2,0,0,13,CLASS
,/lib/:org.jext.dawn.math.MinusFunction,14,2,0,0,16,CLASS
,/lib/:org.jext.dawn.math.ArcCosFunction,11,2,0,0,13,CLASS
,/lib/:org.jext.dawn.math.TimesFunction,12,2,0,0,14,CLASS
,/lib/:org.jext.dawn.math.PlusFunction,12,2,0,0,14,CLASS
,/lib/:org.jext.dawn.math.ArcTanFunction,11,2,0,0,13,CLASS
,/lib/:org.jext.dawn.math.EFunction,11,2,0,0,13,CLASS
,/lib/:org.jext.dawn.math.SinFunction,11,2,0,0,13,CLASS
,/lib/:org.jext.dawn.math.NegFunction,11,2,0,0,13,CLASS
,/lib/:org.jext.dawn.math.DivideFunction,14,2,0,0,16,CLASS
,/lib/:org.jext.dawn.test.LowerThanFunction,13,2,0,0,15,CLASS
,/lib/:org.jext.dawn.test.GreaterThanFunction,13,2,0,0,15,CLASS
,/lib/:org.jext.dawn.test.LowerEqualsFunction,13,2,0,0,15,CLASS
,/lib/:org.jext.dawn.test.NotFunction,12,2,0,0,14,CLASS
,/lib/:org.jext.dawn.test.GetTypeFunction,13,2,0,0,15,CLASS
,/lib/:org.jext.dawn.test.SameFunction,15,2,0,0,17,CLASS
,/lib/:org.jext.dawn.test.IfFunction,99,4,0,0,103,CLASS
,/lib/:org.jext.dawn.test.IsArrayFunction,13,2,0,0,15,CLASS
,/lib/:org.jext.dawn.test.AndFunction,13,2,0,0,15,CLASS
,/lib/:org.jext.dawn.test.EqualsFunction,13,2,0,0,15,CLASS
,/lib/:org.jext.dawn.test.IsLiteralFunction,13,2,0,0,15,CLASS
,/lib/:org.jext.dawn.test.GreaterEqualsFunction,13,2,0,0,15,CLASS
,/lib/:org.jext.dawn.test.DifferentFromFunction,13,2,0,0,15,CLASS
,/lib/:org.jext.dawn.test.XorFunction,13,2,0,0,15,CLASS
,/lib/:org.jext.dawn.test.SameTypeFunction,11,2,0,0,13,CLASS
,/lib/:org.jext.dawn.test.IsStringFunction,13,2,0,0,15,CLASS
,/lib/:org.jext.dawn.test.BinAndFunction,13,2,0,0,15,CLASS
,/lib/:org.jext.dawn.test.IsNumericFunction,13,2,0,0,15,CLASS
,/lib/:org.jext.dawn.test.BinOrFunction,13,2,0,0,15,CLASS
,/lib/:org.jext.dawn.test.OrFunction,13,2,0,0,15,CLASS
,/lib/:org.jext.scripting.python.PythonLogWindow,62,15,0,42,119,CLASS
,/lib/:org.jext.scripting.python.PythonLogWindow$MouseHandler,42,0,0,0,42,INNER_CLASS
,/lib/:org.jext.scripting.python.Run,113,10,0,0,123,CLASS
,/lib/:org.jext.scripting.Logger,6,2,0,0,8,INTERFACE
,/lib/:org.jext.scripting.AbstractLogWindow,57,13,0,11,81,CLASS
,/lib/:org.jext.scripting.AbstractLogWindow$LoggingWriter,11,0,0,0,11,INNER_CLASS
,/lib/:org.jext.scripting.dawn.Run,56,6,0,35,97,CLASS
,/lib/:org.jext.scripting.dawn.Run$ThreadExecuter,35,0,0,0,35,INNER_CLASS
,/lib/:org.jext.scripting.dawn.functions.IsPropertyEnabledFunction,12,3,0,0,15,CLASS
,/lib/:org.jext.scripting.dawn.functions.GetPropertyFunction,12,3,0,0,15,CLASS
,/lib/:org.jext.scripting.dawn.functions.JextActionFunction,18,4,0,0,22,CLASS
,/lib/:org.jext.scripting.dawn.functions.YesNoFunction,16,4,0,0,20,CLASS
,/lib/:org.jext.scripting.dawn.functions.OpenFunction,13,3,0,0,16,CLASS
,/lib/:org.jext.scripting.dawn.functions.InsertTextFunction,13,3,0,0,16,CLASS
,/lib/:org.jext.scripting.dawn.functions.MsgBoxFunction,13,4,0,0,17,CLASS
,/lib/:org.jext.scripting.dawn.functions.SetPropertyFunction,13,3,0,0,16,CLASS
,/lib/:org.jext.scripting.dawn.functions.InputFunction,17,4,0,0,21,CLASS
,/lib/:org.jext.scripting.dawn.functions.CreateActionFunction,24,7,0,13,44,CLASS
,/lib/:org.jext.scripting.dawn.functions.CreateActionFunction$DawnAction,13,0,0,0,13,INNER_CLASS
,/lib/:org.jext.scripting.dawn.functions.GetSelectedTextFunction,13,3,0,0,16,CLASS
,/lib/:org.jext.scripting.dawn.functions.YesNoCancelFunction,16,4,0,0,20,CLASS
,/lib/:org.jext.scripting.dawn.functions.GetTextFunction,13,3,0,0,16,CLASS
,/lib/:org.jext.scripting.dawn.functions.ConsoleFunction,17,4,0,0,21,CLASS
,/lib/:org.jext.scripting.dawn.functions.SetTextFunction,13,3,0,0,16,CLASS
,/lib/:org.jext.scripting.dawn.DawnLogWindow,34,10,0,0,44,CLASS
,/lib/:org.jext.menus.TemplatesMenu,55,14,0,0,69,CLASS
,/lib/:org.jext.menus.JextMenuBar,105,12,0,0,117,CLASS
,/lib/:org.jext.menus.JextRecentMenu,88,9,0,0,97,CLASS
,/lib/:org.jext.oneclick.OneAutoIndent,12,5,0,0,17,CLASS
,/lib/:org.jext.xinsert.XTreeNode,47,3,0,0,50,CLASS
,/lib/:org.jext.xinsert.XTreeObject,34,1,0,0,35,CLASS
,/lib/:org.jext.xinsert.XTree,419,18,0,31,468,CLASS
,/lib/:org.jext.xinsert.XTree$XTreeCellRenderer,31,0,0,0,31,INNER_CLASS
,/lib/:org.jext.xinsert.XTreeItem,41,1,0,0,42,CLASS
,/lib/:org.jext.JextFrame,1170,54,0,88,1312,CLASS
,/lib/:org.jext.JextFrame$WindowHandler,7,0,0,0,7,INNER_CLASS
,/lib/:org.jext.JextFrame$PluginHandler,31,0,0,0,31,INNER_CLASS
,/lib/:org.jext.JextFrame$ModeHandler,13,0,0,0,13,INNER_CLASS
,/lib/:org.jext.JextFrame$DnDHandler,37,0,0,0,37,INNER_CLASS
,/lib/:org.jext.EditAction,3,1,0,0,4,INTERFACE
,/lib/:org.jext.project.ProjectManagement,5,1,0,0,6,INTERFACE
,/lib/:org.jext.project.DefaultProjectManagement,19,3,0,0,22,CLASS
,/lib/:org.jext.project.Project,13,2,0,0,15,INTERFACE
,/lib/:org.jext.project.DefaultProjectManager,145,21,0,103,269,CLASS
,/lib/:org.jext.project.DefaultProjectManager$DefaultProject,103,0,0,0,103,INNER_CLASS
,/lib/:org.jext.project.ProjectEvent,100,2,0,0,102,CLASS
,/lib/:org.jext.project.ProjectListener,4,1,0,0,5,INTERFACE
,/lib/:org.jext.project.AbstractProject,48,4,0,0,52,CLASS
,/lib/:org.jext.project.ProjectManager,12,2,0,0,14,INTERFACE
,/lib/:org.jext.project.AbstractProjectManager,41,5,0,0,46,CLASS
,/lib/:org.jext.Plugin,7,3,0,0,10,INTERFACE
,/lib/:gnu.regexp.REFilterInputStream,54,3,0,0,57,CLASS
,/lib/:gnu.regexp.RETokenBackRef,25,1,0,0,26,CLASS
,/lib/:gnu.regexp.CharIndexedInputStream,83,4,0,0,87,CLASS
,/lib/:gnu.regexp.RETokenOneOf,72,2,0,0,74,CLASS
,/lib/:gnu.regexp.RETokenChar,38,1,0,0,39,CLASS
,/lib/:gnu.regexp.RETokenWordBoundary,43,1,0,0,44,CLASS
,/lib/:gnu.regexp.RETokenPOSIX,91,1,0,0,92,CLASS
,/lib/:gnu.regexp.REToken,35,2,0,0,37,CLASS
,/lib/:gnu.regexp.RETokenRange,25,1,0,0,26,CLASS
,/lib/:gnu.regexp.REFilterReader,54,3,0,0,57,CLASS
,/lib/:gnu.regexp.RETokenEndSub,11,1,0,0,12,CLASS
,/lib/:gnu.regexp.REException,37,2,0,0,39,CLASS
,/lib/:gnu.regexp.CharIndexed,6,1,0,0,7,INTERFACE
,/lib/:gnu.regexp.IntPair,3,8,0,0,11,CLASS
,/lib/:gnu.regexp.CharUnit,4,0,0,0,4,CLASS
,/lib/:gnu.regexp.RE,661,0,0,0,661,CLASS
,/lib/:gnu.regexp.CharIndexedStringBuffer,18,2,0,0,20,CLASS
,/lib/:gnu.regexp.REMatchEnumeration,45,4,0,0,49,CLASS
,/lib/:gnu.regexp.RETokenStart,38,1,0,0,39,CLASS
,/lib/:gnu.regexp.RETokenRepeated,123,2,0,0,125,CLASS
,/lib/:gnu.regexp.CharIndexedReader,91,4,0,0,95,CLASS
,/lib/:gnu.regexp.RESyntax,174,3,0,0,177,CLASS
,/lib/:gnu.regexp.REMatch,104,2,0,0,106,CLASS
,/lib/:gnu.regexp.RETokenEnd,28,1,0,0,29,CLASS
,/lib/:gnu.regexp.RETokenAny,25,1,0,0,26,CLASS
,/lib/:gnu.regexp.RETokenLookAhead,37,1,0,0,38,CLASS
,/lib/:gnu.regexp.CharIndexedString,20,2,0,0,22,CLASS
,/lib/:gnu.regexp.CharIndexedCharArray,18,2,0,0,20,CLASS
,/lib/:gnu.regexp.UncheckedRE,15,1,0,0,16,CLASS
,/updating/PlugReader.java:default.PlugReader,102,6,0,0,108,CLASS
,/updating/ChoiceForm.java:default.ChoiceForm,118,6,0,115,239,CLASS
,/updating/ChoiceForm.java:default.ChoiceForm$DownloadErrorNotify,15,0,0,0,15,INNER_CLASS
,/updating/ChoiceForm.java:default.ChoiceForm$DetailForm,76,0,0,0,76,INNER_CLASS
,/updating/ChoiceForm.java:default.ChoiceForm$PluginTableModel,24,0,0,0,24,INNER_CLASS
Total,,57611,2549,0,6300,66460