,Entity's Name,LOC Count,Header Count,Annotation Count,Inner Entities Lines,Total,Entity Type
,/:sandmark.AppAlgorithm,1,1,0,0,2,INTERFACE
,/:sandmark.gui.MultiLineToolTipUI,150,1,0,0,151,CLASS
,/:sandmark.gui.MethodSorter,21,1,0,0,22,CLASS
,/:sandmark.gui.SandMarkFrame,190,1,0,0,191,CLASS
,/:sandmark.gui.SMAlgHierTreePane,92,1,0,0,93,CLASS
,/:sandmark.gui.SandMarkMenuBar,62,1,0,0,63,CLASS
,/:sandmark.gui.StaticEmbedPanel,119,1,0,0,120,CLASS
,/:sandmark.gui.Utils,15,1,0,98,114,CLASS
,/:sandmark.gui.Utils$LabeledSlider,94,0,0,4,98,INNER_CLASS
,/:sandmark.gui.Utils$LabeledSlider$ValueMapper,4,0,0,0,4,INTERFACE
,/:sandmark.gui.ExtensionFileFilter,15,1,0,0,16,CLASS
,/:sandmark.gui.MethodSliceGUI,89,1,0,0,90,CLASS
,/:sandmark.gui.SliceRenderer,38,0,0,0,38,CLASS
,/:sandmark.gui.SandMarkLiteFrame,14,1,0,0,15,CLASS
,/:sandmark.gui.AppViewPanel,123,1,0,10,134,CLASS
,/:sandmark.gui.AppViewPanel$GraphView,10,0,0,0,10,INNER_CLASS
,/:sandmark.gui.GraphDisplayButton,22,1,0,0,23,CLASS
,/:sandmark.gui.StatTableModel,79,1,0,84,164,CLASS
,/:sandmark.gui.StatTableModel$Stat,11,0,0,0,11,INNER_CLASS
,/:sandmark.gui.StatTableModel$ClassStat,18,0,0,0,18,INNER_CLASS
,/:sandmark.gui.StatTableModel$MethodStat,21,0,0,0,21,INNER_CLASS
,/:sandmark.gui.StatTableModel$StatCalcTask,8,0,0,0,8,INNER_CLASS
,/:sandmark.gui.StatTableModel$StatCalculator,26,0,0,0,26,INNER_CLASS
,/:sandmark.gui.QuickProtectPanel,222,1,0,29,252,CLASS
,/:sandmark.gui.QuickProtectPanel$QuickProtectComboBox,29,0,0,0,29,INNER_CLASS
,/:sandmark.gui.AboutDialog,193,1,0,0,194,CLASS
,/:sandmark.gui.HelpDialog,75,1,0,0,76,CLASS
,/:sandmark.gui.MethodViewPanel,186,1,0,10,197,CLASS
,/:sandmark.gui.MethodViewPanel$GraphView,10,0,0,0,10,INNER_CLASS
,/:sandmark.gui.CurrentApplicationTracker,27,1,0,0,28,CLASS
,/:sandmark.gui.ObfuscatePanel,227,1,0,0,228,CLASS
,/:sandmark.gui.SplashPanel,33,1,0,0,34,CLASS
,/:sandmark.gui.StaticBirthmarkPanel,179,1,0,0,180,CLASS
,/:sandmark.gui.HelpButton,22,1,0,0,23,CLASS
,/:sandmark.gui.FilenameBox,64,1,0,36,101,CLASS
,/:sandmark.gui.FilenameBox$Item,9,0,0,0,9,INNER_CLASS
,/:sandmark.gui.FilenameBox$FileList,27,0,0,0,27,INNER_CLASS
,/:sandmark.gui.DynamicTracePanel,122,1,0,0,123,CLASS
,/:sandmark.gui.NextWMButton,28,1,0,0,29,CLASS
,/:sandmark.gui.MetricTableModel,62,1,0,67,130,CLASS
,/:sandmark.gui.MetricTableModel$MetricGetter,3,0,0,0,3,INNER_CLASS
,/:sandmark.gui.MetricTableModel$AppMetricGetter,10,0,0,0,10,INNER_CLASS
,/:sandmark.gui.MetricTableModel$ClassMetricGetter,10,0,0,0,10,INNER_CLASS
,/:sandmark.gui.MetricTableModel$MethodMetricGetter,10,0,0,0,10,INNER_CLASS
,/:sandmark.gui.MetricTableModel$MetricCalcTask,8,0,0,0,8,INNER_CLASS
,/:sandmark.gui.MetricTableModel$MetricCalculator,26,0,0,0,26,INNER_CLASS
,/:sandmark.gui.ViewPanel,5,1,0,0,6,INTERFACE
,/:sandmark.gui.DynamicRecognizePanel,96,1,0,0,97,CLASS
,/:sandmark.gui.ObfDialog,350,1,0,60,411,CLASS
,/:sandmark.gui.ObfDialog$ObfListModel,60,0,0,0,60,INNER_CLASS
,/:sandmark.gui.OptimisePanel,218,1,0,0,219,CLASS
,/:sandmark.gui.DynamicBirthmarkPanel,183,1,0,0,184,CLASS
,/:sandmark.gui.ClassViewPanel,59,1,0,0,60,CLASS
,/:sandmark.gui.SMAlgHierTreeNode,15,1,0,0,16,CLASS
,/:sandmark.gui.StaticWatermarkPanel,76,1,0,0,77,CLASS
,/:sandmark.gui.diff.ResultsPane,78,1,0,0,79,CLASS
,/:sandmark.gui.diff.DiffFrame,269,1,0,46,316,CLASS
,/:sandmark.gui.diff.DiffFrame$BytecodeEP,29,0,0,17,46,INNER_CLASS
,/:sandmark.gui.diff.DiffFrame$BytecodeEP$MyCellRenderer,17,0,0,0,17,INNER_CLASS
,/:sandmark.gui.diff.DiffOptionsFrame,131,1,0,0,132,CLASS
,/:sandmark.gui.diff.DiffPanel,68,1,0,0,69,CLASS
,/:sandmark.gui.VSplitPanel,137,1,0,8,146,CLASS
,/:sandmark.gui.VSplitPanel$SortPanel,8,0,0,0,8,INNER_CLASS
,/:sandmark.gui.SandMarkViewPanel,68,0,0,0,68,CLASS
,/:sandmark.gui.AlgorithmPanel,6,1,0,0,7,INTERFACE
,/:sandmark.gui.SMarkGUIConstants,75,1,0,0,76,INTERFACE
,/:sandmark.gui.CopyrightDialog,56,1,0,0,57,CLASS
,/:sandmark.gui.WebBrowser,246,1,0,0,247,CLASS
,/:sandmark.gui.JHoverButton,86,0,0,0,86,CLASS
,/:sandmark.gui.SkinPanel,33,1,0,0,34,CLASS
,/:sandmark.gui.SandMarkGUIConstants,48,1,0,0,49,INTERFACE
,/:sandmark.gui.HomePanel,84,1,0,0,85,CLASS
,/:sandmark.gui.DecompileDialog,42,1,0,0,43,CLASS
,/:sandmark.gui.RecognizeButton,30,1,0,0,31,CLASS
,/:sandmark.gui.LogPane,14,1,0,23,38,CLASS
,/:sandmark.gui.LogPane$LogWriter,23,0,0,0,23,INNER_CLASS
,/:sandmark.gui.AlgorithmComboBox,74,1,0,17,92,CLASS
,/:sandmark.gui.AlgorithmComboBox$DescriptionListener,5,0,0,0,5,INTERFACE
,/:sandmark.gui.AlgorithmComboBox$MyComboBoxRenderer,12,0,0,0,12,INNER_CLASS
,/:sandmark.gui.DynamicRecognizeButton,64,1,0,0,65,CLASS
,/:sandmark.gui.DecompilePanel,73,1,0,0,74,CLASS
,/:sandmark.gui.DynamicEmbedPanel,115,1,0,0,116,CLASS
,/:sandmark.gui.ClassSorter,21,1,0,5,27,CLASS
,/:sandmark.gui.ClassSorter$ReverseComparator,5,0,0,0,5,INNER_CLASS
,/:sandmark.gui.ConfigPropertyPanel,88,1,0,0,89,CLASS
,/:sandmark.gui.FileBrowseButtonEventListener,26,0,0,0,26,CLASS
,/:sandmark.gui.JarBrowseButtonEventListener,8,0,0,0,8,CLASS
,/:sandmark.gui.PropertyInfo,26,0,0,0,26,CLASS
,/:sandmark.gui.FieldAndButtonPropertyInfo,39,0,0,0,39,CLASS
,/:sandmark.gui.FilePropertyInfo,33,0,0,0,33,CLASS
,/:sandmark.gui.JarPropertyInfo,10,0,0,0,10,CLASS
,/:sandmark.gui.BooleanPropertyInfo,36,0,0,0,36,CLASS
,/:sandmark.gui.StringPropertyInfo,52,0,0,33,85,CLASS
,/:sandmark.gui.StringPropertyInfo$Widget,5,0,0,0,5,INNER_CLASS
,/:sandmark.gui.StringPropertyInfo$TextField,9,0,0,0,9,INNER_CLASS
,/:sandmark.gui.StringPropertyInfo$ComboBox,19,0,0,0,19,INNER_CLASS
,/:sandmark.gui.IntegerPropertyInfo,11,0,0,0,11,CLASS
,/:sandmark.gui.DoublePropertyInfo,11,0,0,0,11,CLASS
,/:sandmark.gui.ProgramObjectPropertyInfo,64,0,0,0,64,CLASS
,/:sandmark.gui.ClassPropertyInfo,33,0,0,0,33,CLASS
,/:sandmark.gui.MethodPropertyInfo,36,0,0,0,36,CLASS
,/:sandmark.gui.PIFactory,27,0,0,0,27,CLASS
,/:sandmark.gui.LiteHomePanel,77,1,0,0,78,CLASS
,/:sandmark.gui.DynamicWatermarkPanel,85,1,0,0,86,CLASS
,/:sandmark.gui.AppTree,77,1,0,164,242,CLASS
,/:sandmark.gui.AppTree$AppTreeModel,136,0,0,16,152,INNER_CLASS
,/:sandmark.gui.AppTree$AppTreeModel$ModelNode,5,0,0,0,5,INNER_CLASS
,/:sandmark.gui.AppTree$AppTreeModel$ModelNodeComparator,11,0,0,0,11,INNER_CLASS
,/:sandmark.gui.AppTree$TreeViewState,12,0,0,0,12,INNER_CLASS
,/:sandmark.gui.StaticRecognizePanel,94,1,0,0,95,CLASS
,/:sandmark.gui.SandMarkPanel,4,1,0,0,5,INTERFACE
,/:sandmark.program.Application,369,1,0,0,370,CLASS
,/:sandmark.program.LocalClass,41,1,0,0,42,CLASS
,/:sandmark.program.LibraryField,7,1,0,0,8,CLASS
,/:sandmark.program.PathChangeListener,3,1,0,0,4,INTERFACE
,/:sandmark.program.LocalField,11,1,0,0,12,CLASS
,/:sandmark.program.ObjectMemberChangeListener,9,1,0,0,10,INTERFACE
,/:sandmark.program.LocalCPG,6,1,0,0,7,CLASS
,/:sandmark.program.MarkListener,3,1,0,0,4,INTERFACE
,/:sandmark.program.ConstantPoolGen,90,1,0,0,91,CLASS
,/:sandmark.program.UserObjectConstraints,82,1,0,0,83,CLASS
,/:sandmark.program.Method,424,1,0,0,425,CLASS
,/:sandmark.program.File,39,1,0,0,40,CLASS
,/:sandmark.program.util.Reference,33,1,0,0,34,CLASS
,/:sandmark.program.util.Renamer,193,1,0,0,194,CLASS
,/:sandmark.program.util.AllMethods,28,1,0,0,29,CLASS
,/:sandmark.program.LocalMethod,36,1,0,0,37,CLASS
,/:sandmark.program.LibraryMethod,7,1,0,0,8,CLASS
,/:sandmark.program.LibraryClass,36,1,0,0,37,CLASS
,/:sandmark.program.Object,206,1,0,0,207,CLASS
,/:sandmark.program.Field,195,1,0,0,196,CLASS
,/:sandmark.program.JarElement,15,1,0,0,16,CLASS
,/:sandmark.program.Class,482,1,0,0,483,CLASS
,/:sandmark.program.LibraryCPG,70,1,0,0,71,CLASS
,/:sandmark.Algorithm,45,1,0,0,46,CLASS
,/:sandmark.optimise.AppOptimizer,2,1,0,0,3,CLASS
,/:sandmark.optimise.Optimise,90,1,0,0,91,CLASS
,/:sandmark.optimise.ClassOptimizer,2,1,0,0,3,CLASS
,/:sandmark.optimise.OptimizationException,7,1,0,0,8,CLASS
,/:sandmark.optimise.bloat.BLOAT,102,1,0,0,103,CLASS
,/:sandmark.optimise.MethodOptimizer,2,1,0,0,3,CLASS
,/:sandmark.optimise.Optimizer,31,1,0,0,32,CLASS
,/:sandmark.optimise.AllClassesOptimizer,12,1,0,0,13,CLASS
,/:sandmark.optimise.GeneralOptimizer,1,1,0,0,2,INTERFACE
,/:sandmark.smash.SandmarkCLI,390,1,0,0,391,CLASS
,/:sandmark.smash.Smash,142,1,0,0,143,CLASS
,/:sandmark.decompile.Decompile,75,1,0,0,76,CLASS
,/:sandmark.MethodAlgorithm,1,1,0,0,2,INTERFACE
,/:sandmark.util.MethodMerger,146,1,0,0,147,CLASS
,/:sandmark.util.Options,228,1,0,0,229,CLASS
,/:sandmark.util.IdentifierIterator,55,1,0,0,56,CLASS
,/:sandmark.util.StackFrame,36,1,0,0,37,CLASS
,/:sandmark.util.Random,9,1,0,0,10,CLASS
,/:sandmark.util.Inliner,213,1,0,0,214,CLASS
,/:sandmark.util.InlinedStackFrame,38,0,0,0,38,CLASS
,/:sandmark.util.FieldID,42,1,0,0,43,CLASS
,/:sandmark.util.MethodSignatureChanger,111,1,0,0,112,CLASS
,/:sandmark.util.PriorityQueue,92,1,0,50,143,CLASS
,/:sandmark.util.PriorityQueue$Ascending,25,0,0,0,25,INNER_CLASS
,/:sandmark.util.PriorityQueue$Descending,25,0,0,0,25,INNER_CLASS
,/:sandmark.util.StringInt,39,1,0,0,40,CLASS
,/:sandmark.util.Combinations,53,1,0,0,54,CLASS
,/:sandmark.util.StaticSplit,54,1,0,0,55,CLASS
,/:sandmark.util.ConfigPropertyChangeListener,4,1,0,0,5,INTERFACE
,/:sandmark.util.exprtree.NodeInfo,59,1,0,0,60,CLASS
,/:sandmark.util.exprtree.DependencyGraph,355,1,0,18,374,CLASS
,/:sandmark.util.exprtree.DependencyGraph$BlockComparator,18,0,0,0,18,INNER_CLASS
,/:sandmark.util.exprtree.Node,15,1,0,0,16,CLASS
,/:sandmark.util.exprtree.ExprTree,593,1,0,58,652,CLASS
,/:sandmark.util.exprtree.ExprTree$NodeComparator,22,0,0,0,22,INNER_CLASS
,/:sandmark.util.exprtree.ExprTree$GraphComparator,36,0,0,0,36,INNER_CLASS
,/:sandmark.util.Node,5,1,0,0,6,CLASS
,/:sandmark.util.CircularBuffer,64,0,0,18,82,CLASS
,/:sandmark.util.CircularBuffer$Iterator,18,0,0,0,18,INNER_CLASS
,/:sandmark.util.Math,73,1,0,0,74,CLASS
,/:sandmark.util.MethodCaller,50,1,0,0,51,CLASS
,/:sandmark.util.splitint.PartialSumSplitter,78,1,0,0,79,CLASS
,/:sandmark.util.splitint.CombinationSplitter,104,1,0,0,105,CLASS
,/:sandmark.util.splitint.FastCRTSplitter,71,1,0,0,72,CLASS
,/:sandmark.util.splitint.IntSplitter,5,1,0,0,6,INTERFACE
,/:sandmark.util.splitint.SlowCRTSplitter,140,1,0,0,141,CLASS
,/:sandmark.util.splitint.ResidueSplitter,7,1,0,0,8,CLASS
,/:sandmark.util.splitint.ScaledSplitter,93,1,0,0,94,CLASS
,/:sandmark.util.splitint.CRTSplitter,264,1,0,26,291,CLASS
,/:sandmark.util.splitint.CRTSplitter$Congruence,26,0,0,0,26,INNER_CLASS
,/:sandmark.util.splitint.AdditiveSplitter,54,1,0,0,55,CLASS
,/:sandmark.util.splitint.ValueSplitter,70,1,0,0,71,CLASS
,/:sandmark.util.InstructionTree,59,1,0,21,81,CLASS
,/:sandmark.util.InstructionTree$BTN,21,0,0,0,21,INNER_CLASS
,/:sandmark.util.stealth.Cluster,378,1,0,0,379,CLASS
,/:sandmark.util.stealth.Stealth,82,1,0,0,83,CLASS
,/:sandmark.util.ByteCodeLocation,42,1,0,0,43,CLASS
,/:sandmark.util.SparseVector,48,1,0,25,74,CLASS
,/:sandmark.util.SparseVector$Iterator,25,0,0,0,25,INNER_CLASS
,/:sandmark.util.Dot,138,1,0,0,139,CLASS
,/:sandmark.util.exec.MethodCallData,120,1,0,0,121,CLASS
,/:sandmark.util.exec.Output,48,1,0,0,49,CLASS
,/:sandmark.util.exec.HeapNode,13,1,0,0,14,CLASS
,/:sandmark.util.exec.TracingException,8,1,0,0,9,CLASS
,/:sandmark.util.exec.HeapData,32,1,0,0,33,CLASS
,/:sandmark.util.exec.DumpAll,74,1,0,0,75,CLASS
,/:sandmark.util.exec.EventHandler,12,1,0,0,13,CLASS
,/:sandmark.util.exec.Breakpoint,54,1,0,0,55,CLASS
,/:sandmark.util.exec.Overseer,106,1,0,0,107,CLASS
,/:sandmark.util.exec.Heap,247,1,0,0,248,CLASS
,/:sandmark.util.exec.EventThread,192,1,0,18,211,CLASS
,/:sandmark.util.exec.EventThread$BreakpointEvent,10,0,0,0,10,INNER_CLASS
,/:sandmark.util.exec.EventThread$ExitBreakpoint,8,0,0,0,8,INNER_CLASS
,/:sandmark.util.opaquepredicatelib.StringOpPredicateGenerator,119,1,0,0,120,CLASS
,/:sandmark.util.opaquepredicatelib.IntComparePredicateGenerator,91,1,0,0,92,CLASS
,/:sandmark.util.opaquepredicatelib.ObjectComparePredicateGenerator,130,1,0,0,131,CLASS
,/:sandmark.util.opaquepredicatelib.PredicateFactory,37,1,0,0,38,CLASS
,/:sandmark.util.opaquepredicatelib.AlgebraicPredicateGenerator,108,1,0,0,109,CLASS
,/:sandmark.util.opaquepredicatelib.OpaqueManager,63,1,0,0,64,CLASS
,/:sandmark.util.opaquepredicatelib.smNode,216,1,0,0,217,CLASS
,/:sandmark.util.opaquepredicatelib.OpaquePredicateGenerator,84,1,0,0,85,CLASS
,/:sandmark.util.opaquepredicatelib.DataStructurePredicateGenerator,28,1,0,0,29,CLASS
,/:sandmark.util.opaquepredicatelib.DSPGF1,266,0,0,0,266,CLASS
,/:sandmark.util.opaquepredicatelib.DSPGF2,395,0,0,0,395,CLASS
,/:sandmark.util.opaquepredicatelib.DSPGT1,308,0,0,0,308,CLASS
,/:sandmark.util.opaquepredicatelib.DSPGT2,268,0,0,0,268,CLASS
,/:sandmark.util.opaquepredicatelib.PredicateInfo,8,1,0,0,9,CLASS
,/:sandmark.util.opaquepredicatelib.ThreadPredicateGenerator,283,1,0,0,284,CLASS
,/:sandmark.util.opaquepredicatelib.ExprTree,510,1,0,0,511,CLASS
,/:sandmark.util.primitivepromotion.LocalPromoter,229,1,0,0,230,CLASS
,/:sandmark.util.primitivepromotion.ParamPromoter,151,1,0,0,152,CLASS
,/:sandmark.util.primitivepromotion.ReturnPromoter,97,1,0,0,98,CLASS
,/:sandmark.util.primitivepromotion.PromoterException,7,1,0,0,8,CLASS
,/:sandmark.util.primitivepromotion.PromoterUtil,48,1,0,0,49,CLASS
,/:sandmark.util.newexprtree.ComputeExprTree,591,1,0,58,650,CLASS
,/:sandmark.util.newexprtree.ComputeExprTree$NodeComparator,22,0,0,0,22,INNER_CLASS
,/:sandmark.util.newexprtree.ComputeExprTree$GraphComparator,36,0,0,0,36,INNER_CLASS
,/:sandmark.util.newexprtree.ExprTreeCFG,1651,1,0,0,1652,CLASS
,/:sandmark.util.newexprtree.ComparisonExpr,56,1,0,0,57,CLASS
,/:sandmark.util.newexprtree.InstanceofExpr,29,1,0,0,30,CLASS
,/:sandmark.util.newexprtree.BinaryArithmeticExpr,87,1,0,0,88,CLASS
,/:sandmark.util.newexprtree.ConversionExpr,82,1,0,0,83,CLASS
,/:sandmark.util.newexprtree.IfExpr,157,1,0,0,158,CLASS
,/:sandmark.util.newexprtree.ArithmeticExpr,25,1,0,0,26,CLASS
,/:sandmark.util.newexprtree.JsrExpr,17,1,0,0,18,CLASS
,/:sandmark.util.newexprtree.NewExpr,15,1,0,0,16,CLASS
,/:sandmark.util.newexprtree.PutFieldExpr,61,1,0,0,62,CLASS
,/:sandmark.util.newexprtree.BranchExpr,19,1,0,0,20,CLASS
,/:sandmark.util.newexprtree.ExprTreeBlock,30,1,0,0,31,CLASS
,/:sandmark.util.newexprtree.NodeInfo,59,1,0,0,60,CLASS
,/:sandmark.util.newexprtree.ArrayLengthExpr,23,1,0,0,24,CLASS
,/:sandmark.util.newexprtree.MonitorExpr,29,1,0,0,30,CLASS
,/:sandmark.util.newexprtree.BasicBlock,37,1,0,0,38,CLASS
,/:sandmark.util.newexprtree.ArrayLoadExpr,55,1,0,0,56,CLASS
,/:sandmark.util.newexprtree.NegateArithmeticExpr,41,1,0,0,42,CLASS
,/:sandmark.util.newexprtree.SwitchExpr,79,1,0,0,80,CLASS
,/:sandmark.util.newexprtree.ValueExpr,9,1,0,0,10,CLASS
,/:sandmark.util.newexprtree.InvokeExpr,68,1,0,0,69,CLASS
,/:sandmark.util.newexprtree.StringConstantExpr,19,1,0,0,20,CLASS
,/:sandmark.util.newexprtree.NullConstantExpr,17,1,0,0,18,CLASS
,/:sandmark.util.newexprtree.ConstantExpr,6,1,0,0,7,CLASS
,/:sandmark.util.newexprtree.ReturnAddressDummyExpr,8,1,0,0,9,CLASS
,/:sandmark.util.newexprtree.ObjectDummyExpr,11,1,0,0,12,CLASS
,/:sandmark.util.newexprtree.DependencyGraph,345,1,0,18,364,CLASS
,/:sandmark.util.newexprtree.DependencyGraph$BlockComparator,18,0,0,0,18,INNER_CLASS
,/:sandmark.util.newexprtree.NumericConstantExpr,23,1,0,0,24,CLASS
,/:sandmark.util.newexprtree.ThrowExpr,22,1,0,0,23,CLASS
,/:sandmark.util.newexprtree.ArrayStoreExpr,63,1,0,0,64,CLASS
,/:sandmark.util.newexprtree.ExceptionInfo,35,1,0,0,36,CLASS
,/:sandmark.util.newexprtree.PrimitiveDummyExpr,8,1,0,0,9,CLASS
,/:sandmark.util.newexprtree.Node,15,1,0,0,16,CLASS
,/:sandmark.util.newexprtree.ArrayDummyExpr,17,1,0,0,18,CLASS
,/:sandmark.util.newexprtree.DummyExpr,9,1,0,0,10,CLASS
,/:sandmark.util.newexprtree.StoreExpr,39,1,0,0,40,CLASS
,/:sandmark.util.newexprtree.IncExpr,25,1,0,0,26,CLASS
,/:sandmark.util.newexprtree.LoadExpr,26,1,0,0,27,CLASS
,/:sandmark.util.newexprtree.NopExpr,12,1,0,0,13,CLASS
,/:sandmark.util.newexprtree.RetExpr,18,1,0,0,19,CLASS
,/:sandmark.util.newexprtree.GotoExpr,17,1,0,0,18,CLASS
,/:sandmark.util.newexprtree.MethodExprTree,53,1,0,0,54,CLASS
,/:sandmark.util.newexprtree.Expr,4,1,0,0,5,CLASS
,/:sandmark.util.newexprtree.NewArrayExpr,35,1,0,0,36,CLASS
,/:sandmark.util.newexprtree.ExceptionDummyExpr,12,1,0,0,13,CLASS
,/:sandmark.util.newexprtree.ExprTree,94,1,0,0,95,CLASS
,/:sandmark.util.newexprtree.GetFieldExpr,48,1,0,0,49,CLASS
,/:sandmark.util.newexprtree.ReturnExpr,39,1,0,0,40,CLASS
,/:sandmark.util.newexprtree.ExprTreeNode,40,1,0,0,41,CLASS
,/:sandmark.util.javagen.Return,36,1,0,0,37,CLASS
,/:sandmark.util.javagen.StaticFunCall,86,1,0,0,87,CLASS
,/:sandmark.util.javagen.StaticRef,35,1,0,0,36,CLASS
,/:sandmark.util.javagen.AssignStatic,44,1,0,0,45,CLASS
,/:sandmark.util.javagen.LiteralString,31,1,0,0,32,CLASS
,/:sandmark.util.javagen.EmptyStatement,22,1,0,0,23,CLASS
,/:sandmark.util.javagen.IfNotNull,57,1,0,0,58,CLASS
,/:sandmark.util.javagen.LocalRef,35,1,0,0,36,CLASS
,/:sandmark.util.javagen.Method,87,1,0,0,88,CLASS
,/:sandmark.util.javagen.New,75,1,0,0,76,CLASS
,/:sandmark.util.javagen.Block,28,1,0,0,29,CLASS
,/:sandmark.util.javagen.LoadIndex,36,1,0,0,37,CLASS
,/:sandmark.util.javagen.Field,56,1,0,0,57,CLASS
,/:sandmark.util.javagen.VirtualFunCall,97,1,0,0,98,CLASS
,/:sandmark.util.javagen.Local,51,1,0,0,52,CLASS
,/:sandmark.util.javagen.Expression,15,1,0,0,16,CLASS
,/:sandmark.util.javagen.Java,116,1,0,0,117,CLASS
,/:sandmark.util.javagen.AssignIndex,42,1,0,0,43,CLASS
,/:sandmark.util.javagen.MyClass,33,1,0,0,34,CLASS
,/:sandmark.util.javagen.Formal,53,1,0,0,54,CLASS
,/:sandmark.util.javagen.Try,82,1,0,0,83,CLASS
,/:sandmark.util.javagen.Statement,8,1,0,0,9,CLASS
,/:sandmark.util.javagen.AssignField,53,1,0,0,54,CLASS
,/:sandmark.util.javagen.Class,121,1,0,0,122,CLASS
,/:sandmark.util.javagen.NewArray,40,1,0,0,41,CLASS
,/:sandmark.util.javagen.Test,240,1,0,0,241,CLASS
,/:sandmark.util.javagen.StaticCall,87,1,0,0,88,CLASS
,/:sandmark.util.javagen.Cast,37,1,0,0,38,CLASS
,/:sandmark.util.javagen.Discard,27,1,0,0,28,CLASS
,/:sandmark.util.javagen.VirtualCall,97,1,0,0,98,CLASS
,/:sandmark.util.javagen.CondNotNullExpr,62,1,0,0,63,CLASS
,/:sandmark.util.javagen.FieldRef,43,1,0,0,44,CLASS
,/:sandmark.util.javagen.Comment,19,1,0,0,20,CLASS
,/:sandmark.util.javagen.LiteralInt,32,1,0,0,33,CLASS
,/:sandmark.util.javagen.Null,24,1,0,0,25,CLASS
,/:sandmark.util.javagen.List,96,1,0,0,97,CLASS
,/:sandmark.util.MethodID,60,1,0,0,61,CLASS
,/:sandmark.util.outliner.OutlineUtil,2077,1,0,0,2078,CLASS
,/:sandmark.util.outliner.Outliner,61,1,0,0,62,CLASS
,/:sandmark.util.outliner.OutlineFrame,26,0,0,0,26,CLASS
,/:sandmark.util.outliner.LiveVar,42,1,0,0,43,CLASS
,/:sandmark.util.ParamReorder,121,1,0,0,122,CLASS
,/:sandmark.util.Misc,263,1,0,0,264,CLASS
,/:sandmark.util.newgraph.Graph,628,1,0,285,914,CLASS
,/:sandmark.util.newgraph.Graph$SuccIterator,50,0,0,0,50,INNER_CLASS
,/:sandmark.util.newgraph.Graph$PredIterator,50,0,0,0,50,INNER_CLASS
,/:sandmark.util.newgraph.Graph$DepthFirstIterator,70,0,0,0,70,INNER_CLASS
,/:sandmark.util.newgraph.Graph$PostOrderIterator,57,0,0,6,63,INNER_CLASS
,/:sandmark.util.newgraph.Graph$PostOrderIterator$PathElement,6,0,0,0,6,INNER_CLASS
,/:sandmark.util.newgraph.Graph$BreadthFirstIterator,52,0,0,0,52,INNER_CLASS
,/:sandmark.util.newgraph.ImplNodeAttributes,10,1,0,0,11,CLASS
,/:sandmark.util.newgraph.ImplNodeWrapper,6,0,0,0,6,CLASS
,/:sandmark.util.newgraph.GraphImpl,153,0,0,0,153,CLASS
,/:sandmark.util.newgraph.MissingEdgeWrapperIterator,26,1,0,0,27,CLASS
,/:sandmark.util.newgraph.MutableIteratorWrapper,16,1,0,0,17,CLASS
,/:sandmark.util.newgraph.MutableGraph,171,0,0,22,193,CLASS
,/:sandmark.util.newgraph.MutableGraph$EdgeIterator,11,0,0,0,11,INNER_CLASS
,/:sandmark.util.newgraph.MutableGraph$NodeIterator,11,0,0,0,11,INNER_CLASS
,/:sandmark.util.newgraph.Path,111,1,0,0,112,CLASS
,/:sandmark.util.newgraph.NodeWrapperIterator,21,1,0,0,22,CLASS
,/:sandmark.util.newgraph.EdgeSet,71,1,0,22,94,CLASS
,/:sandmark.util.newgraph.EdgeSet$WrapperListIterator,22,0,0,0,22,INNER_CLASS
,/:sandmark.util.newgraph.RecursiveGraph,19,1,0,0,20,CLASS
,/:sandmark.util.newgraph.NodeWrapper,97,1,0,0,98,CLASS
,/:sandmark.util.newgraph.MissingGraph,42,1,0,0,43,CLASS
,/:sandmark.util.newgraph.DoubleEdgeWrapperIterator,28,1,0,0,29,CLASS
,/:sandmark.util.newgraph.Style,13,1,0,0,14,INTERFACE
,/:sandmark.util.newgraph.SingleNodeWrapperIterator,11,1,0,0,12,CLASS
,/:sandmark.util.newgraph.Status,17,1,0,0,18,CLASS
,/:sandmark.util.newgraph.DoubleNodeWrapperIterator,24,1,0,0,25,CLASS
,/:sandmark.util.newgraph.SingleEdgeWrapperIterator,14,1,0,0,15,CLASS
,/:sandmark.util.newgraph.StatusEdgeSet,24,1,0,0,25,CLASS
,/:sandmark.util.newgraph.EdgeWrapper,11,1,0,0,12,CLASS
,/:sandmark.util.newgraph.Afs,97,1,0,0,98,CLASS
,/:sandmark.util.newgraph.GraphListener,3,1,0,0,4,INTERFACE
,/:sandmark.util.newgraph.EdgeIteratorWrapper,23,1,0,0,24,CLASS
,/:sandmark.util.newgraph.codec.CatalanNumbers,20,1,0,0,21,CLASS
,/:sandmark.util.newgraph.codec.TypedEdgeCodec,2,1,0,0,3,INTERFACE
,/:sandmark.util.newgraph.codec.GraphCodec,13,1,0,0,14,INTERFACE
,/:sandmark.util.newgraph.codec.ReduciblePermutationGraph,277,1,0,174,452,CLASS
,/:sandmark.util.newgraph.codec.ReduciblePermutationGraph$BackEdge,15,0,0,0,15,INNER_CLASS
,/:sandmark.util.newgraph.codec.ReduciblePermutationGraph$Decoder,159,0,0,0,159,INNER_CLASS
,/:sandmark.util.newgraph.codec.CycleAndPathWrapper,311,1,0,17,329,CLASS
,/:sandmark.util.newgraph.codec.CycleAndPathWrapper$CycleState,17,0,0,0,17,INNER_CLASS
,/:sandmark.util.newgraph.codec.DecodeFailure,8,1,0,0,9,CLASS
,/:sandmark.util.newgraph.codec.CycleAndDigitsCodec,182,1,0,0,183,CLASS
,/:sandmark.util.newgraph.codec.PermutationGraph,58,1,0,0,59,CLASS
,/:sandmark.util.newgraph.codec.RadixGraph,40,1,0,0,41,CLASS
,/:sandmark.util.newgraph.codec.DefaultNodeFactory,6,1,0,0,7,CLASS
,/:sandmark.util.newgraph.codec.AbstractCodec,40,0,0,0,40,CLASS
,/:sandmark.util.newgraph.codec.TotallyBalancedBinarySequence,105,1,0,0,106,CLASS
,/:sandmark.util.newgraph.codec.PlantedPlaneCubicTree,225,1,0,13,239,CLASS
,/:sandmark.util.newgraph.codec.PlantedPlaneCubicTree$BTreeNode,8,0,0,0,8,INNER_CLASS
,/:sandmark.util.newgraph.codec.PlantedPlaneCubicTree$NTreeNode,5,0,0,0,5,INNER_CLASS
,/:sandmark.util.newgraph.codec.WrapperCodec,3,1,0,0,4,INTERFACE
,/:sandmark.util.newgraph.ExtraEdgeWrapperIterator,22,1,0,0,23,CLASS
,/:sandmark.util.newgraph.ExtraNodeGraph,64,1,0,0,65,CLASS
,/:sandmark.util.newgraph.MissingNodeAttributes,4,1,0,0,5,CLASS
,/:sandmark.util.newgraph.MissingNodeIterator,29,0,0,0,29,CLASS
,/:sandmark.util.newgraph.MissingStuffGraph,154,0,0,45,199,CLASS
,/:sandmark.util.newgraph.MissingStuffGraph$MissingNodeWrapperIterator,22,0,0,0,22,INNER_CLASS
,/:sandmark.util.newgraph.MissingStuffGraph$MissingEdgeWrapperIterator,23,0,0,0,23,INNER_CLASS
,/:sandmark.util.newgraph.AbstractStyle,76,1,0,10,87,CLASS
,/:sandmark.util.newgraph.AbstractStyle$NodeAttributes,6,0,0,0,6,INNER_CLASS
,/:sandmark.util.newgraph.AbstractStyle$EdgeAttributes,4,0,0,0,4,INNER_CLASS
,/:sandmark.util.newgraph.ImmutableGraphStyle,18,0,0,0,18,CLASS
,/:sandmark.util.newgraph.MutableGraphStyle,18,0,0,0,18,CLASS
,/:sandmark.util.newgraph.AbstractGraphStyle,8,0,0,0,8,CLASS
,/:sandmark.util.newgraph.Node,30,1,0,0,31,CLASS
,/:sandmark.util.newgraph.Graphs,153,1,0,0,154,CLASS
,/:sandmark.util.newgraph.EdgelessGraph,115,1,0,0,116,CLASS
,/:sandmark.util.newgraph.Edge,6,1,0,0,7,INTERFACE
,/:sandmark.util.newgraph.MissingNodeGraph,94,1,0,0,95,CLASS
,/:sandmark.util.newgraph.GraphStyle,35,1,0,0,36,INTERFACE
,/:sandmark.util.newgraph.NodeFactory,3,1,0,0,4,INTERFACE
,/:sandmark.util.newgraph.EmptyGraph,86,1,0,0,87,CLASS
,/:sandmark.util.newgraph.DomNodeWrapper,11,1,0,0,12,CLASS
,/:sandmark.util.newgraph.TreeNodeWrapper,17,0,0,0,17,CLASS
,/:sandmark.util.newgraph.EdgeWrapperArrayIterator,25,0,0,0,25,CLASS
,/:sandmark.util.newgraph.DomTree,222,0,0,0,222,CLASS
,/:sandmark.util.newgraph.ReversedGraph,74,1,0,14,89,CLASS
,/:sandmark.util.newgraph.ReversedGraph$ReversedEdgeIterator,14,0,0,0,14,INNER_CLASS
,/:sandmark.util.newgraph.ExtraNodeAttributes,4,1,0,0,5,CLASS
,/:sandmark.util.newgraph.ExtraNodeIterator,29,0,0,0,29,CLASS
,/:sandmark.util.newgraph.ExtraStuffGraph,161,0,0,0,161,CLASS
,/:sandmark.util.newgraph.EditableGraphStyle,358,1,0,94,453,CLASS
,/:sandmark.util.newgraph.EditableGraphStyle$Pair,19,0,0,0,19,INNER_CLASS
,/:sandmark.util.newgraph.EditableGraphStyle$NodeAttributes,46,0,0,0,46,INNER_CLASS
,/:sandmark.util.newgraph.EditableGraphStyle$EdgeAttributes,29,0,0,0,29,INNER_CLASS
,/:sandmark.util.newgraph.NodeAttributes,20,1,0,0,21,CLASS
,/:sandmark.util.newgraph.EdgeWrapperIterator,22,1,0,0,23,CLASS
,/:sandmark.util.newgraph.LabeledEdge,26,1,0,0,27,CLASS
,/:sandmark.util.newgraph.ExtraEdgeGraph,73,1,0,0,74,CLASS
,/:sandmark.util.newgraph.MissingEdgeGraph,76,1,0,0,77,CLASS
,/:sandmark.util.newgraph.LabeledNode,4,1,0,0,5,INTERFACE
,/:sandmark.util.newgraph.EdgeImpl,26,1,0,0,27,CLASS
,/:sandmark.util.newgraph.ExtraGraph,27,1,0,0,28,CLASS
,/:sandmark.util.newgraph.ExtraNodeWrapperIterator,17,1,0,0,18,CLASS
,/:sandmark.util.newgraph.TypedEdge,11,1,0,0,12,CLASS
,/:sandmark.util.WeakBuffer,30,1,0,0,31,CLASS
,/:sandmark.util.SignatureBludgeoner,141,1,0,0,142,CLASS
,/:sandmark.util.ArrayIterator,20,1,0,0,21,CLASS
,/:sandmark.util.MultiIter,61,1,0,0,62,CLASS
,/:sandmark.util.Log,49,1,0,19,69,CLASS
,/:sandmark.util.Log$Logger,14,0,0,0,14,INNER_CLASS
,/:sandmark.util.Log$Message,5,0,0,0,5,INNER_CLASS
,/:sandmark.util.SingleObjectIterator,8,1,0,0,9,CLASS
,/:sandmark.util.classloading.FileClassFinder,63,1,0,0,64,CLASS
,/:sandmark.util.classloading.ClassFinder,53,1,0,0,54,CLASS
,/:sandmark.util.classloading.BuildClassList,30,1,0,0,31,CLASS
,/:sandmark.util.classloading.DirClassFinder,96,1,0,0,97,CLASS
,/:sandmark.util.classloading.IClassFinder,84,1,0,0,85,INTERFACE
,/:sandmark.util.classloading.JarClassFinder,104,1,0,0,105,CLASS
,/:sandmark.util.TempDir,26,1,0,0,27,CLASS
,/:sandmark.util.ConfigProperties,141,1,0,177,319,CLASS
,/:sandmark.util.ConfigProperties$PropSpec,110,0,0,17,127,INNER_CLASS
,/:sandmark.util.ConfigProperties$PropSpec$Listener,17,0,0,0,17,INNER_CLASS
,/:sandmark.util.ConfigProperties$LocalPropIter,15,0,0,0,15,INNER_CLASS
,/:sandmark.util.ConfigProperties$PropIter,31,0,0,0,31,INNER_CLASS
,/:sandmark.util.ConfigProperties$ConfigPropertyException,4,0,0,0,4,INNER_CLASS
,/:sandmark.util.Publicizer,199,1,0,0,200,CLASS
,/:sandmark.util.graph.graphview.GraphLayout,139,1,0,0,140,CLASS
,/:sandmark.util.graph.graphview.DummyNode,4,1,0,0,5,CLASS
,/:sandmark.util.graph.graphview.CreateGraph,186,1,0,0,187,CLASS
,/:sandmark.util.graph.graphview.SimpleGraphLayout,19,1,0,0,20,CLASS
,/:sandmark.util.graph.graphview.GraphViewFrame,196,1,0,0,197,CLASS
,/:sandmark.util.graph.graphview.TreeLayout,44,1,0,0,45,CLASS
,/:sandmark.util.graph.graphview.MutableGraphPanel,15,1,0,0,16,CLASS
,/:sandmark.util.graph.graphview.LayeredDrawingLayout,536,1,0,20,557,CLASS
,/:sandmark.util.graph.graphview.LayeredDrawingLayout$LayerInfo,11,0,0,0,11,INNER_CLASS
,/:sandmark.util.graph.graphview.LayeredDrawingLayout$EdgeInfo,9,0,0,0,9,INNER_CLASS
,/:sandmark.util.graph.graphview.GraphZoomSlider,32,1,0,0,33,CLASS
,/:sandmark.util.graph.graphview.GraphList,68,1,0,12,81,CLASS
,/:sandmark.util.graph.graphview.GraphList$GraphInfo,12,0,0,0,12,INNER_CLASS
,/:sandmark.util.graph.graphview.GraphPanel,388,1,0,32,421,CLASS
,/:sandmark.util.graph.graphview.GraphPanel$MyMouseListener,32,0,0,0,32,INNER_CLASS
,/:sandmark.util.graph.graphview.NodeDisplayInfo,120,1,0,0,121,CLASS
,/:sandmark.util.graph.graphview.EdgeDisplayInfo,25,1,0,0,26,CLASS
,/:sandmark.util.graph.graphview.HierarchyTreeLayout,27,1,0,0,28,CLASS
,/:sandmark.util.graph.graphview.SpringEmbedderLayout,118,1,0,9,128,CLASS
,/:sandmark.util.graph.graphview.SpringEmbedderLayout$NodeInfo,9,0,0,0,9,INNER_CLASS
,/:sandmark.util.MethodReceiver,64,1,0,0,65,CLASS
,/:sandmark.util.Enum2Iter,17,1,0,0,18,CLASS
,/:sandmark.eclipse.SandMarkConfigTab,152,13,0,0,165,CLASS
,/:sandmark.eclipse.SandMarkLaunchDelegate,29,10,0,0,39,CLASS
,/:sandmark.eclipse.SandMarkTabGroup,9,8,0,0,17,CLASS
,/:sandmark.eclipse.ConfigPropertyPanel,76,6,0,3,85,CLASS
,/:sandmark.eclipse.ConfigPropertyPanel$ChangeListener,3,0,0,0,3,INTERFACE
,/:sandmark.eclipse.PropertyInfo,26,0,0,0,26,CLASS
,/:sandmark.eclipse.FieldAndButtonPropertyInfo,21,0,0,0,21,CLASS
,/:sandmark.eclipse.FilePropertyInfo,31,0,0,0,31,CLASS
,/:sandmark.eclipse.JarPropertyInfo,10,0,0,0,10,CLASS
,/:sandmark.eclipse.BooleanPropertyInfo,26,0,0,0,26,CLASS
,/:sandmark.eclipse.StringPropertyInfo,37,0,0,52,89,CLASS
,/:sandmark.eclipse.StringPropertyInfo$Widget,5,0,0,0,5,INNER_CLASS
,/:sandmark.eclipse.StringPropertyInfo$TextField,18,0,0,0,18,INNER_CLASS
,/:sandmark.eclipse.StringPropertyInfo$ComboBox,29,0,0,0,29,INNER_CLASS
,/:sandmark.eclipse.IntegerPropertyInfo,11,0,0,0,11,CLASS
,/:sandmark.eclipse.DoublePropertyInfo,11,0,0,0,11,CLASS
,/:sandmark.eclipse.PIFactory,23,0,0,0,23,CLASS
,/:sandmark.eclipse.SandMarkPlugin,61,11,0,0,72,CLASS
,/:sandmark.newstatistics.Stats,970,1,0,0,971,CLASS
,/:sandmark.newstatistics.Statistics,18,1,0,0,19,CLASS
,/:sandmark.newstatistics.CFGwidth,288,1,0,21,310,CLASS
,/:sandmark.newstatistics.CFGwidth$Range,21,0,0,0,21,INNER_CLASS
,/:sandmark.newstatistics.StatisticsRecord,770,1,0,10,781,CLASS
,/:sandmark.newstatistics.StatisticsRecord$StaticFieldData,10,0,0,0,10,INNER_CLASS
,/:sandmark.newstatistics.CFGdepth,84,1,0,26,111,CLASS
,/:sandmark.newstatistics.CFGdepth$Scope,26,0,0,0,26,INNER_CLASS
,/:sandmark.visualize.Visualize,37,1,0,0,38,CLASS
,/:sandmark.visualize.heap.SQL,63,1,0,0,64,CLASS
,/:sandmark.visualize.heap.HeapVisualizer,25,1,0,16,42,CLASS
,/:sandmark.visualize.heap.HeapVisualizer$InitBreakpoint,16,0,0,0,16,INNER_CLASS
,/:sandmark.Console,43,1,0,0,44,CLASS
,/:sandmark.ClassAlgorithm,1,1,0,0,2,INTERFACE
,/:sandmark.watermark.DynamicEmbedParameters,5,1,0,0,6,CLASS
,/:sandmark.watermark.execpath.VarValue,101,1,0,0,102,CLASS
,/:sandmark.watermark.execpath.SMLinkedList,9,1,0,0,10,CLASS
,/:sandmark.watermark.execpath.SandmarkListHolder,98,0,0,0,98,CLASS
,/:sandmark.watermark.execpath.ContextCodeGen,126,1,0,0,127,CLASS
,/:sandmark.watermark.execpath.RecognitionIterator,36,1,0,0,37,CLASS
,/:sandmark.watermark.execpath.TraceGetter,161,1,0,0,162,CLASS
,/:sandmark.watermark.execpath.ConditionGenerator,1086,1,0,0,1087,CLASS
,/:sandmark.watermark.execpath.Tracer,600,1,0,0,601,CLASS
,/:sandmark.watermark.execpath.LoopCodeGen,93,1,0,0,94,CLASS
,/:sandmark.watermark.execpath.Analyzer,175,1,0,50,226,CLASS
,/:sandmark.watermark.execpath.Analyzer$Method,19,0,0,0,19,INNER_CLASS
,/:sandmark.watermark.execpath.Analyzer$Instruction,13,0,0,0,13,INNER_CLASS
,/:sandmark.watermark.execpath.Analyzer$InstructionInfo,9,0,0,0,9,INNER_CLASS
,/:sandmark.watermark.execpath.Analyzer$ThreadInfo,9,0,0,0,9,INNER_CLASS
,/:sandmark.watermark.execpath.NodeIterator,26,1,0,0,27,CLASS
,/:sandmark.watermark.execpath.EPW,331,1,0,5,337,CLASS
,/:sandmark.watermark.execpath.EPW$Insertion,5,0,0,0,5,INNER_CLASS
,/:sandmark.watermark.execpath.TraceIndexer,62,1,0,31,94,CLASS
,/:sandmark.watermark.execpath.TraceIndexer$TracePoint,31,0,0,0,31,INNER_CLASS
,/:sandmark.watermark.execpath.StreamPump,16,1,0,0,17,CLASS
,/:sandmark.watermark.execpath.TraceReader,18,1,0,0,19,CLASS
,/:sandmark.watermark.execpath.TraceNode,74,1,0,0,75,CLASS
,/:sandmark.watermark.execpath.WMCodeGen,136,1,0,25,162,CLASS
,/:sandmark.watermark.execpath.WMCodeGen$CodeGenException,3,0,0,0,3,INNER_CLASS
,/:sandmark.watermark.execpath.WMCodeGen$PushBackIterator,22,0,0,0,22,INNER_CLASS
,/:sandmark.watermark.StaticRecognizeParameters,4,1,0,0,5,CLASS
,/:sandmark.watermark.WatermarkingException,8,1,0,0,9,CLASS
,/:sandmark.watermark.arboit.UtilFunctions,612,1,0,0,613,CLASS
,/:sandmark.watermark.arboit.AlgOP,1844,1,0,0,1845,CLASS
,/:sandmark.watermark.arboit.ArboitAlg,101,1,0,24,126,CLASS
,/:sandmark.watermark.arboit.ArboitAlg$Recognizer,24,0,0,0,24,INNER_CLASS
,/:sandmark.watermark.arboit.Bundle,36,1,0,0,37,CLASS
,/:sandmark.watermark.arboit.trace.TracePoint,42,1,0,0,43,CLASS
,/:sandmark.watermark.arboit.trace.Annotate,51,1,0,0,52,CLASS
,/:sandmark.watermark.arboit.trace.Tracer,34,1,0,19,54,CLASS
,/:sandmark.watermark.arboit.trace.Tracer$Breakpoint,19,0,0,0,19,INNER_CLASS
,/:sandmark.watermark.arboit.trace.Annotator,6,1,0,0,7,CLASS
,/:sandmark.watermark.arboit.DynamicAA,229,1,0,0,230,CLASS
,/:sandmark.watermark.DynamicWatermarker,133,1,0,0,134,CLASS
,/:sandmark.watermark.util.MD5Marker,200,1,0,20,221,CLASS
,/:sandmark.watermark.util.MD5Marker$TrivialIterator,20,0,0,0,20,INNER_CLASS
,/:sandmark.watermark.util.StaticWriteParityMarker,112,1,0,20,133,CLASS
,/:sandmark.watermark.util.StaticWriteParityMarker$TrivialIterator,20,0,0,0,20,INNER_CLASS
,/:sandmark.watermark.util.MethodMarker,10,1,0,0,11,CLASS
,/:sandmark.watermark.util.EveryBlockMarker,63,1,0,23,87,CLASS
,/:sandmark.watermark.util.EveryBlockMarker$CountOrderer,23,0,0,0,23,INNER_CLASS
,/:sandmark.watermark.util.InsnCountMarker,8,1,0,0,9,CLASS
,/:sandmark.watermark.util.PutstaticCountMarker,24,1,0,0,25,CLASS
,/:sandmark.watermark.util.BasicBlockMarker,13,1,0,0,14,CLASS
,/:sandmark.watermark.ct.FindWindows,31,1,0,108,140,CLASS
,/:sandmark.watermark.ct.FindWindows$Window,20,0,0,0,20,INNER_CLASS
,/:sandmark.watermark.ct.FindWindows$WindowState,88,0,0,0,88,INNER_CLASS
,/:sandmark.watermark.ct.embed.PrepareTrace,161,1,0,10,172,CLASS
,/:sandmark.watermark.ct.embed.PrepareTrace$TraceLocation,10,0,0,0,10,INNER_CLASS
,/:sandmark.watermark.ct.embed.Inliner,68,1,0,0,69,CLASS
,/:sandmark.watermark.ct.embed.InsertStorageCreators,95,1,0,0,96,CLASS
,/:sandmark.watermark.ct.embed.Distribute,212,1,0,31,244,CLASS
,/:sandmark.watermark.ct.embed.Distribute$TraceLocation,10,0,0,0,10,INNER_CLASS
,/:sandmark.watermark.ct.embed.Distribute$ClassHierarchy,21,0,0,0,21,INNER_CLASS
,/:sandmark.watermark.ct.embed.AddParameters,314,1,0,0,315,CLASS
,/:sandmark.watermark.ct.embed.EmbedData,22,1,0,0,23,CLASS
,/:sandmark.watermark.ct.embed.Embedder,187,1,0,0,188,CLASS
,/:sandmark.watermark.ct.embed.ReplaceWMClass,253,1,0,0,254,CLASS
,/:sandmark.watermark.ct.embed.InsertionPoints,241,1,0,0,242,CLASS
,/:sandmark.watermark.ct.embed.DeleteMarkCalls,76,1,0,0,77,CLASS
,/:sandmark.watermark.ct.embed.MarkLocation,78,1,0,0,79,CLASS
,/:sandmark.watermark.ct.embed.InsertionPoint,22,0,0,0,22,CLASS
,/:sandmark.watermark.ct.embed.ReplaceMarkCalls,74,0,0,0,74,CLASS
,/:sandmark.watermark.ct.recognize.Recognizer,25,1,0,168,194,CLASS
,/:sandmark.watermark.ct.recognize.Recognizer$InitBreakpoint,11,0,0,0,11,INNER_CLASS
,/:sandmark.watermark.ct.recognize.Recognizer$Watermarks,101,0,0,0,101,INNER_CLASS
,/:sandmark.watermark.ct.recognize.Recognizer$DecodedGraph,9,0,0,0,9,INNER_CLASS
,/:sandmark.watermark.ct.recognize.Recognizer$Graphs,47,0,0,0,47,INNER_CLASS
,/:sandmark.watermark.ct.recognize.RecognizeData,49,1,0,0,50,CLASS
,/:sandmark.watermark.ct.recognize.Heap2Graph,32,1,0,0,33,CLASS
,/:sandmark.watermark.ct.encode.ir2ir.Destructors,71,1,0,0,72,CLASS
,/:sandmark.watermark.ct.encode.ir2ir.CleanUp,100,1,0,0,101,CLASS
,/:sandmark.watermark.ct.encode.ir2ir.AddCasts,56,1,0,0,57,CLASS
,/:sandmark.watermark.ct.encode.ir2ir.Protect,108,1,0,0,109,CLASS
,/:sandmark.watermark.ct.encode.ir2ir.Builder,38,1,0,0,39,CLASS
,/:sandmark.watermark.ct.encode.ir2ir.AddFields,75,1,0,0,76,CLASS
,/:sandmark.watermark.ct.encode.ir2ir.Transformer,11,1,0,0,12,CLASS
,/:sandmark.watermark.ct.encode.ir2ir.AddFormals,65,1,0,0,66,CLASS
,/:sandmark.watermark.ct.encode.ir2ir.SaveNodes,98,1,0,0,99,CLASS
,/:sandmark.watermark.ct.encode.ir2ir.Debug,21,1,0,0,22,CLASS
,/:sandmark.watermark.ct.encode.ir2ir.InlineFixups,44,1,0,0,45,CLASS
,/:sandmark.watermark.ct.encode.Graph2IR,228,1,0,15,244,CLASS
,/:sandmark.watermark.ct.encode.Graph2IR$Path,15,0,0,0,15,INNER_CLASS
,/:sandmark.watermark.ct.encode.Encoder,128,1,0,0,129,CLASS
,/:sandmark.watermark.ct.encode.ir.Destroy,38,1,0,0,39,CLASS
,/:sandmark.watermark.ct.encode.ir.Build,159,1,0,0,160,CLASS
,/:sandmark.watermark.ct.encode.ir.Construct,31,1,0,0,32,CLASS
,/:sandmark.watermark.ct.encode.ir.Fixup,43,1,0,0,44,CLASS
,/:sandmark.watermark.ct.encode.ir.PrintGraph,15,1,0,0,16,CLASS
,/:sandmark.watermark.ct.encode.ir.Destruct,31,1,0,0,32,CLASS
,/:sandmark.watermark.ct.encode.ir.Method,45,1,0,0,46,CLASS
,/:sandmark.watermark.ct.encode.ir.SaveNode,24,1,0,0,25,CLASS
,/:sandmark.watermark.ct.encode.ir.LoadNode,23,1,0,0,24,CLASS
,/:sandmark.watermark.ct.encode.ir.Create,36,1,0,0,37,CLASS
,/:sandmark.watermark.ct.encode.ir.AddEdge,54,1,0,0,55,CLASS
,/:sandmark.watermark.ct.encode.ir.IR,42,1,0,0,43,CLASS
,/:sandmark.watermark.ct.encode.ir.Field,35,1,0,0,36,CLASS
,/:sandmark.watermark.ct.encode.ir.FollowLink,74,1,0,0,75,CLASS
,/:sandmark.watermark.ct.encode.ir.Formal,21,1,0,0,22,CLASS
,/:sandmark.watermark.ct.encode.ir.NodeStorage,14,1,0,0,15,CLASS
,/:sandmark.watermark.ct.encode.ir.ProtectRegion,26,1,0,0,27,CLASS
,/:sandmark.watermark.ct.encode.ir.Init,32,1,0,0,33,CLASS
,/:sandmark.watermark.ct.encode.ir.CreateNode,31,1,0,0,32,CLASS
,/:sandmark.watermark.ct.encode.ir.Debug,22,1,0,0,23,CLASS
,/:sandmark.watermark.ct.encode.ir.StaticCall,27,1,0,0,28,CLASS
,/:sandmark.watermark.ct.encode.ir.FieldAccessor,4,1,0,0,5,INTERFACE
,/:sandmark.watermark.ct.encode.ir.CreateStorage,57,1,0,0,58,CLASS
,/:sandmark.watermark.ct.encode.ir.List,106,1,0,14,121,CLASS
,/:sandmark.watermark.ct.encode.ir.List$Backwards,14,0,0,0,14,INNER_CLASS
,/:sandmark.watermark.ct.encode.Split,215,1,0,4,220,CLASS
,/:sandmark.watermark.ct.encode.Split$SplitException,4,0,0,0,4,INNER_CLASS
,/:sandmark.watermark.ct.encode.storage.Hash,83,1,0,0,84,CLASS
,/:sandmark.watermark.ct.encode.storage.StorageClass,37,1,0,0,38,CLASS
,/:sandmark.watermark.ct.encode.storage.Array,67,1,0,0,68,CLASS
,/:sandmark.watermark.ct.encode.storage.GlobalStorage,101,1,0,0,102,CLASS
,/:sandmark.watermark.ct.encode.storage.NodeStorage,31,1,0,0,32,CLASS
,/:sandmark.watermark.ct.encode.storage.Pointer,72,1,0,0,73,CLASS
,/:sandmark.watermark.ct.encode.storage.Vector,101,1,0,0,102,CLASS
,/:sandmark.watermark.ct.CT,327,1,0,0,328,CLASS
,/:sandmark.watermark.ct.Evaluate,82,1,0,0,83,CLASS
,/:sandmark.watermark.ct.trace.TracePoint,58,1,0,0,59,CLASS
,/:sandmark.watermark.ct.trace.callforest.CallFrame,23,1,0,0,24,CLASS
,/:sandmark.watermark.ct.trace.callforest.Build,154,1,0,25,180,CLASS
,/:sandmark.watermark.ct.trace.callforest.Build$Data,25,0,0,0,25,INNER_CLASS
,/:sandmark.watermark.ct.trace.callforest.Path,138,1,0,0,139,CLASS
,/:sandmark.watermark.ct.trace.callforest.Node,150,1,0,0,151,CLASS
,/:sandmark.watermark.ct.trace.callforest.Edge,27,1,0,0,28,CLASS
,/:sandmark.watermark.ct.trace.callforest.Decorate,240,1,0,0,241,CLASS
,/:sandmark.watermark.ct.trace.callforest.Forest,73,1,0,0,74,CLASS
,/:sandmark.watermark.ct.trace.callforest.PathGenerator,45,1,0,0,46,CLASS
,/:sandmark.watermark.ct.trace.callforest.AllPathsIterator,57,0,0,27,84,CLASS
,/:sandmark.watermark.ct.trace.callforest.AllPathsIterator$Afs,27,0,0,0,27,INNER_CLASS
,/:sandmark.watermark.ct.trace.callforest.Test,271,1,0,48,320,CLASS
,/:sandmark.watermark.ct.trace.callforest.Test$Stats,38,0,0,0,38,INNER_CLASS
,/:sandmark.watermark.ct.trace.callforest.Test$ClassHierarchy,10,0,0,0,10,INNER_CLASS
,/:sandmark.watermark.ct.trace.Tracer,35,1,0,31,67,CLASS
,/:sandmark.watermark.ct.trace.Tracer$Breakpoint,31,0,0,0,31,INNER_CLASS
,/:sandmark.watermark.ct.trace.Preprocessor,71,1,0,0,72,CLASS
,/:sandmark.watermark.ct.trace.Annotator,24,1,0,0,25,CLASS
,/:sandmark.watermark.StaticWatermarker,63,1,0,0,64,CLASS
,/:sandmark.watermark.steganography.Steganography,255,1,0,62,318,CLASS
,/:sandmark.watermark.steganography.Steganography$StegIterator,62,0,0,0,62,INNER_CLASS
,/:sandmark.watermark.steganography.ImageHider,56,1,0,0,57,CLASS
,/:sandmark.watermark.steganography.StegLoader,105,1,0,0,106,CLASS
,/:sandmark.watermark.StaticRecognize,12,1,0,0,13,CLASS
,/:sandmark.watermark.bogusswitch.Bogus_Switch,94,1,0,48,143,CLASS
,/:sandmark.watermark.bogusswitch.Bogus_Switch$Recognizer,48,0,0,0,48,INNER_CLASS
,/:sandmark.watermark.mondenwmark.MondenWmark,384,1,0,0,385,CLASS
,/:sandmark.watermark.GeneralWatermarker,24,1,0,0,25,CLASS
,/:sandmark.watermark.objectwm.Profiler,159,1,0,0,160,CLASS
,/:sandmark.watermark.objectwm.ObjectWatermark,181,1,0,166,348,CLASS
,/:sandmark.watermark.objectwm.ObjectWatermark$Recognizer,166,0,0,0,166,INNER_CLASS
,/:sandmark.watermark.objectwm.VectorExtraction,66,1,0,0,67,CLASS
,/:sandmark.watermark.objectwm.CodeBook,348,1,0,0,349,CLASS
,/:sandmark.watermark.objectwm.VectorUpdateCtrl,101,1,0,0,102,CLASS
,/:sandmark.watermark.objectwm.MethodCopyUtil,780,1,0,0,781,CLASS
,/:sandmark.watermark.objectwm.ObjectHelper,131,1,0,0,132,CLASS
,/:sandmark.watermark.objectwm.SubstitutionUtil,130,1,0,0,131,CLASS
,/:sandmark.watermark.objectwm.Insertion,291,1,0,0,292,CLASS
,/:sandmark.watermark.objectwm.InstructionEmbedUtil,704,1,0,0,705,CLASS
,/:sandmark.watermark.objectwm.ObjectUtil,356,1,0,0,357,CLASS
,/:sandmark.watermark.objectwm.Config,76,1,0,0,77,CLASS
,/:sandmark.watermark.bogusinitializer.BogusInitializer,109,1,0,67,177,CLASS
,/:sandmark.watermark.bogusinitializer.BogusInitializer$Recognizer,67,0,0,0,67,INNER_CLASS
,/:sandmark.watermark.hattrick.HatTrick,184,1,0,71,256,CLASS
,/:sandmark.watermark.hattrick.HatTrick$Recognizer,71,0,0,0,71,INNER_CLASS
,/:sandmark.watermark.assignlv.ToBinary,88,1,0,0,89,CLASS
,/:sandmark.watermark.assignlv.MethodCompare,60,1,0,0,61,CLASS
,/:sandmark.watermark.assignlv.AssignLV,207,1,0,171,379,CLASS
,/:sandmark.watermark.assignlv.AssignLV$Recognizer,171,0,0,0,171,INNER_CLASS
,/:sandmark.watermark.assignlv.FromBinary,68,1,0,0,69,CLASS
,/:sandmark.watermark.assignlv.ToArray,11,1,0,0,12,CLASS
,/:sandmark.watermark.assignlv.ClassNameMethodBundle,25,1,0,0,26,CLASS
,/:sandmark.watermark.DynamicRecognizeParameters,5,1,0,0,6,CLASS
,/:sandmark.watermark.gtw.ClusterGraph,58,1,0,0,59,CLASS
,/:sandmark.watermark.gtw.CFGComparator,11,0,0,0,11,CLASS
,/:sandmark.watermark.gtw.eigen.Graph,37,2,0,19,58,CLASS
,/:sandmark.watermark.gtw.eigen.Graph$Edge,19,0,0,0,19,INNER_CLASS
,/:sandmark.watermark.gtw.eigen.GraphEigenvalues,25,4,0,0,29,CLASS
,/:sandmark.watermark.gtw.eigen.SumsPanel,38,3,0,0,41,CLASS
,/:sandmark.watermark.gtw.eigen.EigenData,10,2,0,0,12,CLASS
,/:sandmark.watermark.gtw.eigen.SumData,55,4,0,42,101,CLASS
,/:sandmark.watermark.gtw.eigen.SumData$DataSet,30,0,0,0,30,INNER_CLASS
,/:sandmark.watermark.gtw.eigen.SumData$SumListener,12,0,0,0,12,INNER_CLASS
,/:sandmark.watermark.gtw.eigen.GraphListener,4,2,0,0,6,INTERFACE
,/:sandmark.watermark.gtw.eigen.KPartiteGraphData,27,1,0,0,28,CLASS
,/:sandmark.watermark.gtw.eigen.RandomGraphData,24,1,0,0,25,CLASS
,/:sandmark.watermark.gtw.eigen.EigenPanel,55,6,0,0,61,CLASS
,/:sandmark.watermark.gtw.eigen.RepaintingListener,22,3,0,0,25,CLASS
,/:sandmark.watermark.gtw.eigen.GraphPanel,31,4,0,0,35,CLASS
,/:sandmark.watermark.gtw.eigen.GraphData,73,5,0,17,95,CLASS
,/:sandmark.watermark.gtw.eigen.GraphData$BestFitParams,17,0,0,0,17,INNER_CLASS
,/:sandmark.watermark.gtw.eigen.BasicListener,3,1,0,0,4,INTERFACE
,/:sandmark.watermark.gtw.GTWRecognizer,153,1,0,12,166,CLASS
,/:sandmark.watermark.gtw.GTWRecognizer$MarkedMethod,12,0,0,0,12,INNER_CLASS
,/:sandmark.watermark.gtw.FunctionClusterGraph,222,1,0,0,223,CLASS
,/:sandmark.watermark.gtw.GTW,343,1,0,0,344,CLASS
,/:sandmark.watermark.DynamicTraceParameters,6,1,0,0,7,CLASS
,/:sandmark.watermark.addmethfield.AddMethField,178,1,0,51,230,CLASS
,/:sandmark.watermark.addmethfield.AddMethField$Recognizer,51,0,0,0,51,INNER_CLASS
,/:sandmark.watermark.constantstring.ConstantString,74,1,0,36,111,CLASS
,/:sandmark.watermark.constantstring.ConstantString$Recognizer,36,0,0,0,36,INNER_CLASS
,/:sandmark.watermark.constantstring.Program,3,1,0,0,4,CLASS
,/:sandmark.watermark.dm.DM,282,1,0,446,729,CLASS
,/:sandmark.watermark.dm.DM$BlockRecognizer,235,0,0,0,235,INNER_CLASS
,/:sandmark.watermark.dm.DM$Relinker,90,0,0,18,108,INNER_CLASS
,/:sandmark.watermark.dm.DM$Relinker$IHPair,18,0,0,0,18,INNER_CLASS
,/:sandmark.watermark.dm.DM$MethodChooser,103,0,0,0,103,INNER_CLASS
,/:sandmark.watermark.bogusexp.BogusExpression,169,1,0,100,270,CLASS
,/:sandmark.watermark.bogusexp.BogusExpression$Recognizer,100,0,0,0,100,INNER_CLASS
,/:sandmark.watermark.StaticEmbed,11,1,0,0,12,CLASS
,/:sandmark.watermark.StaticEmbedParameters,5,1,0,0,6,CLASS
,/:sandmark.config.RequisiteProperty,3,1,0,0,4,CLASS
,/:sandmark.config.ModificationProperty,84,1,0,0,85,CLASS
,/:sandmark.config.AlgorithmProperty,29,1,0,0,30,CLASS
,/:sandmark.diff.LCS,71,1,0,0,72,CLASS
,/:sandmark.diff.DiffUtil,133,1,0,0,134,CLASS
,/:sandmark.diff.DiffAlgorithm,26,1,0,0,27,CLASS
,/:sandmark.diff.DiffOptions,58,1,0,0,59,CLASS
,/:sandmark.diff.InstructionWrapper,173,1,0,0,174,CLASS
,/:sandmark.diff.Monitorable,5,1,0,0,6,INTERFACE
,/:sandmark.diff.Coloring,42,1,0,10,53,CLASS
,/:sandmark.diff.Coloring$Line,10,0,0,0,10,INNER_CLASS
,/:sandmark.diff.Result,27,1,0,0,28,CLASS
,/:sandmark.diff.methoddiff.BakerAlgorithm,121,1,0,0,122,CLASS
,/:sandmark.diff.methoddiff.TupleList,22,1,0,0,23,CLASS
,/:sandmark.diff.methoddiff.CFGDiff,113,1,0,18,132,CLASS
,/:sandmark.diff.methoddiff.CFGDiff$CFGResult,18,0,0,0,18,INNER_CLASS
,/:sandmark.diff.methoddiff.CFGTreeNode,45,1,0,0,46,CLASS
,/:sandmark.diff.methoddiff.DMDiffAlgorithm,157,1,0,0,158,CLASS
,/:sandmark.diff.methoddiff.TrivialDiffAlgorithm,94,1,0,0,95,CLASS
,/:sandmark.diff.methoddiff.MethodDiffAlgorithm,78,1,0,0,79,CLASS
,/:sandmark.diff.methoddiff.CFGTree,255,1,0,0,256,CLASS
,/:sandmark.diff.methoddiff.ComparableBlock,47,1,0,0,48,CLASS
,/:sandmark.diff.methoddiff.Tuple,23,1,0,0,24,CLASS
,/:sandmark.diff.classdiff.ConstPoolDiff,48,1,0,0,49,CLASS
,/:sandmark.diff.classdiff.ClassDiffAlgorithm,60,1,0,0,61,CLASS
,/:sandmark.metric.CkClassInheritanceMeasure,18,1,0,0,19,CLASS
,/:sandmark.metric.HalsteadMethodVolumeMeasure,29,1,0,0,30,CLASS
,/:sandmark.metric.HalsteadAppEffortMeasure,26,1,0,0,27,CLASS
,/:sandmark.metric.NestingLevelComplexity,163,1,0,21,185,CLASS
,/:sandmark.metric.NestingLevelComplexity$ComplexityNode,21,0,0,0,21,INNER_CLASS
,/:sandmark.metric.ClassMetric,20,1,0,0,21,CLASS
,/:sandmark.metric.CkAppInheritanceMeasure,24,1,0,0,25,CLASS
,/:sandmark.metric.MunsonAppMeasure,23,1,0,0,24,CLASS
,/:sandmark.metric.KafuraAppMeasure,25,1,0,0,26,CLASS
,/:sandmark.metric.MethodComparator,19,1,0,0,20,CLASS
,/:sandmark.metric.AppIdentifierLength,31,1,0,0,32,CLASS
,/:sandmark.metric.McCabeMethodMeasure,19,1,0,0,20,CLASS
,/:sandmark.metric.HarrisonAppMeasure,25,1,0,0,26,CLASS
,/:sandmark.metric.ApplicationMetric,20,1,0,0,21,CLASS
,/:sandmark.metric.HalsteadMethodEffortMeasure,38,1,0,0,39,CLASS
,/:sandmark.metric.HalsteadClassVocabMeasure,27,1,0,0,28,CLASS
,/:sandmark.metric.HalsteadAppMeasure,26,1,0,0,27,CLASS
,/:sandmark.metric.ClassOpcodeComparator,21,1,0,0,22,CLASS
,/:sandmark.metric.HalsteadAppLengthMeasure,25,1,0,0,26,CLASS
,/:sandmark.metric.KafuraClassMeasure,185,1,0,0,186,CLASS
,/:sandmark.metric.ClassComparator,19,1,0,0,20,CLASS
,/:sandmark.metric.CkAppCouplingMeasure,26,1,0,0,27,CLASS
,/:sandmark.metric.HalsteadMethodDifficultyMeasure,35,1,0,0,36,CLASS
,/:sandmark.metric.MunsonClassMeasure,24,1,0,0,25,CLASS
,/:sandmark.metric.HalsteadMethodLengthMeasure,27,1,0,0,28,CLASS
,/:sandmark.metric.HalsteadAppDifficultyMeasure,27,1,0,0,28,CLASS
,/:sandmark.metric.HalsteadClassLengthMeasure,27,1,0,0,28,CLASS
,/:sandmark.metric.HalsteadClassDifficultyMeasure,28,1,0,0,29,CLASS
,/:sandmark.metric.MethodMetric,20,1,0,0,21,CLASS
,/:sandmark.metric.FakeMetric,14,1,0,0,15,CLASS
,/:sandmark.metric.HalsteadClassMeasure,26,1,0,0,27,CLASS
,/:sandmark.metric.CkAppMeasure,23,1,0,0,24,CLASS
,/:sandmark.metric.HalsteadClassVolumeMeasure,28,1,0,0,29,CLASS
,/:sandmark.metric.HalsteadUtil,181,1,0,0,182,CLASS
,/:sandmark.metric.CkClassSubclassMeasure,18,1,0,0,19,CLASS
,/:sandmark.metric.LocalIdentifierLength,37,1,0,0,38,CLASS
,/:sandmark.metric.HalsteadAppVocabMeasure,25,1,0,0,26,CLASS
,/:sandmark.metric.MunsonMethodMeasure,32,1,0,0,33,CLASS
,/:sandmark.metric.MethodOpcodeComparator,21,1,0,0,22,CLASS
,/:sandmark.metric.HarrisonClassMeasure,24,1,0,0,25,CLASS
,/:sandmark.metric.CkClassResponseMeasure,28,1,0,0,29,CLASS
,/:sandmark.metric.ApplicationComparator,19,1,0,0,20,CLASS
,/:sandmark.metric.StatsUtil,288,1,0,0,289,CLASS
,/:sandmark.metric.McCabeClassMeasure,24,1,0,0,25,CLASS
,/:sandmark.metric.HalsteadMethodMeasure,37,1,0,0,38,CLASS
,/:sandmark.metric.HarrisonMethodMeasure,28,1,0,0,29,CLASS
,/:sandmark.metric.ClassIdentifierLength,32,1,0,0,33,CLASS
,/:sandmark.metric.CkClassMeasure,36,1,0,0,37,CLASS
,/:sandmark.metric.McCabeAppMeasure,23,1,0,0,24,CLASS
,/:sandmark.metric.HalsteadMethodVocabMeasure,27,1,0,0,28,CLASS
,/:sandmark.metric.HalsteadClassEffortMeasure,27,1,0,0,28,CLASS
,/:sandmark.metric.CkAppResponseMeasure,25,1,0,0,26,CLASS
,/:sandmark.metric.HalsteadAppVolumeMeasure,25,1,0,0,26,CLASS
,/:sandmark.metric.Metric,27,1,0,0,28,CLASS
,/:sandmark.metric.CkAppSubclassMeasure,25,1,0,0,26,CLASS
,/:sandmark.metric.CkClassCouplingMeasure,23,1,0,0,24,CLASS
,/:sandmark.analysis.initialized.Initialized,48,1,0,0,49,CLASS
,/:sandmark.analysis.slicingtools.BackwardMethodSlice,229,1,0,0,230,CLASS
,/:sandmark.analysis.slicingtools.ForwardMethodSlice,219,1,0,0,220,CLASS
,/:sandmark.analysis.slicingtools.AnalysisBlock,49,1,0,0,50,CLASS
,/:sandmark.analysis.slicingtools.MethodSlice,157,1,0,0,158,CLASS
,/:sandmark.analysis.interference.InterferenceGraph,47,1,0,0,48,CLASS
,/:sandmark.analysis.stacksimulator.ReferenceData,25,1,0,0,26,CLASS
,/:sandmark.analysis.stacksimulator.ReplaceVarContext,30,1,0,0,31,CLASS
,/:sandmark.analysis.stacksimulator.UninitializedReferenceData,26,1,0,0,27,CLASS
,/:sandmark.analysis.stacksimulator.ReturnaddressData,28,1,0,0,29,CLASS
,/:sandmark.analysis.stacksimulator.MergeContext,65,1,0,0,66,CLASS
,/:sandmark.analysis.stacksimulator.PushContext,35,1,0,0,36,CLASS
,/:sandmark.analysis.stacksimulator.Context,173,1,0,0,174,CLASS
,/:sandmark.analysis.stacksimulator.UndefinedContext,41,1,0,0,42,CLASS
,/:sandmark.analysis.stacksimulator.CaughtExceptionData,21,1,0,0,22,CLASS
,/:sandmark.analysis.stacksimulator.StackSimulator,1823,1,0,0,1824,CLASS
,/:sandmark.analysis.stacksimulator.PopContext,23,1,0,0,24,CLASS
,/:sandmark.analysis.stacksimulator.StackData,23,1,0,0,24,CLASS
,/:sandmark.analysis.stacksimulator.ArrayReferenceData,41,0,0,0,41,CLASS
,/:sandmark.analysis.stacksimulator.IntData,27,0,0,0,27,CLASS
,/:sandmark.analysis.stacksimulator.CompositeIntData,40,0,0,0,40,CLASS
,/:sandmark.analysis.stacksimulator.LongData,27,0,0,0,27,CLASS
,/:sandmark.analysis.stacksimulator.BooleanData,27,0,0,0,27,CLASS
,/:sandmark.analysis.stacksimulator.DoubleData,27,0,0,0,27,CLASS
,/:sandmark.analysis.stacksimulator.FloatData,27,0,0,0,27,CLASS
,/:sandmark.analysis.stacksimulator.CompositeBooleanData,32,0,0,0,32,CLASS
,/:sandmark.analysis.stacksimulator.CompositeLongData,32,0,0,0,32,CLASS
,/:sandmark.analysis.stacksimulator.CompositeDoubleData,32,0,0,0,32,CLASS
,/:sandmark.analysis.stacksimulator.CompositeFloatData,32,0,0,0,32,CLASS
,/:sandmark.analysis.stacksimulator.PrimitiveData,50,1,0,0,51,CLASS
,/:sandmark.analysis.stacksimulator.ClearStackContext,19,1,0,0,20,CLASS
,/:sandmark.analysis.stacksimulator.ReplaceStackContext,30,1,0,0,31,CLASS
,/:sandmark.analysis.stacksimulator.EmptyContext,21,1,0,0,22,CLASS
,/:sandmark.analysis.callgraph.ApplicationCFG,126,1,0,0,127,CLASS
,/:sandmark.analysis.callgraph.CallGraph,192,1,0,0,193,CLASS
,/:sandmark.analysis.callgraph.CallGraphEdge,30,1,0,0,31,CLASS
,/:sandmark.analysis.classhierarchy.ClassHierarchyException,7,1,0,0,8,CLASS
,/:sandmark.analysis.classhierarchy.ClassHierarchy,562,1,0,0,563,CLASS
,/:sandmark.analysis.controlflowgraph.NullNENullCallGenerator,308,1,0,0,309,CLASS
,/:sandmark.analysis.controlflowgraph.PositiveIntSynthesizer,408,1,0,0,409,CLASS
,/:sandmark.analysis.controlflowgraph.RegisterAllocator,133,1,0,0,134,CLASS
,/:sandmark.analysis.controlflowgraph.TopoMaintainingCallGenerator,148,1,0,0,149,CLASS
,/:sandmark.analysis.controlflowgraph.ExceptionEdge,19,1,0,0,20,CLASS
,/:sandmark.analysis.controlflowgraph.MinimalSynthesizer,192,1,0,0,193,CLASS
,/:sandmark.analysis.controlflowgraph.EmptyMethodException,8,1,0,0,9,CLASS
,/:sandmark.analysis.controlflowgraph.VoidMethodSynthesizer,15,1,0,0,16,CLASS
,/:sandmark.analysis.controlflowgraph.CallGenerator,3,1,0,0,4,INTERFACE
,/:sandmark.analysis.controlflowgraph.CallingCallGenerator,285,1,0,0,286,CLASS
,/:sandmark.analysis.controlflowgraph.BasicBlock,79,1,0,91,171,CLASS
,/:sandmark.analysis.controlflowgraph.BasicBlock$BBArrayList,91,0,0,0,91,INNER_CLASS
,/:sandmark.analysis.controlflowgraph.SimpleGotoSynthesizer,49,1,0,0,50,CLASS
,/:sandmark.analysis.controlflowgraph.SimpleSwitchSynthesizer,64,1,0,0,65,CLASS
,/:sandmark.analysis.controlflowgraph.MethodCFG,542,1,0,31,574,CLASS
,/:sandmark.analysis.controlflowgraph.MethodCFG$BasicBlockIterator,31,0,0,0,31,INNER_CLASS
,/:sandmark.analysis.controlflowgraph.IntFuncSynthesizer,43,1,0,12,56,CLASS
,/:sandmark.analysis.controlflowgraph.IntFuncSynthesizer$ILOAD_UNSPEC,6,0,0,0,6,INNER_CLASS
,/:sandmark.analysis.controlflowgraph.IntFuncSynthesizer$ISTORE_UNSPEC,6,0,0,0,6,INNER_CLASS
,/:sandmark.analysis.controlflowgraph.ProgramCFG,94,1,0,0,95,CLASS
,/:sandmark.analysis.controlflowgraph.CodeContext,41,1,0,0,42,CLASS
,/:sandmark.analysis.controlflowgraph.FallthroughEdge,5,1,0,0,6,CLASS
,/:sandmark.analysis.controlflowgraph.Edge,14,1,0,0,15,CLASS
,/:sandmark.analysis.controlflowgraph.ControlFlowSynthesizer,104,1,0,0,105,CLASS
,/:sandmark.analysis.dependencygraph.DependencyGraph,54,1,0,0,55,CLASS
,/:sandmark.analysis.liveness.Liveness,170,1,0,0,171,CLASS
,/:sandmark.analysis.liveness.BBInfo,10,0,0,0,10,CLASS
,/:sandmark.analysis.defuse.InstructionDefWrapper,32,1,0,0,33,CLASS
,/:sandmark.analysis.defuse.ThisDefWrapper,16,1,0,0,17,CLASS
,/:sandmark.analysis.defuse.DUWeb,129,1,0,0,130,CLASS
,/:sandmark.analysis.defuse.IHComparator,15,0,0,0,15,CLASS
,/:sandmark.analysis.defuse.DefComparator,27,0,0,0,27,CLASS
,/:sandmark.analysis.defuse.ReachingDefs,397,1,0,6,404,CLASS
,/:sandmark.analysis.defuse.ReachingDefs$CachedDef,6,0,0,0,6,INNER_CLASS
,/:sandmark.analysis.defuse.BBInfo,10,0,0,0,10,CLASS
,/:sandmark.analysis.defuse.UseInfo,9,0,0,0,9,CLASS
,/:sandmark.analysis.defuse.UninitializedDefWrapper,6,1,0,0,7,CLASS
,/:sandmark.analysis.defuse.ParamDefWrapper,26,1,0,0,27,CLASS
,/:sandmark.analysis.defuse.StoreDefWrapper,6,1,0,0,7,CLASS
,/:sandmark.analysis.defuse.DefWrapper,17,1,0,0,18,CLASS
,/:sandmark.analysis.defuse.IncDefWrapper,8,1,0,0,9,CLASS
,/:sandmark.Constants,45,1,0,0,46,CLASS
,/:sandmark.obfuscate.renameidentifiers.RenameLocals,182,1,0,0,183,CLASS
,/:sandmark.obfuscate.boolsplitter.BoolSplitter,370,1,0,0,371,CLASS
,/:sandmark.obfuscate.dynamicinliner.DynamicInliner,310,1,0,0,311,CLASS
,/:sandmark.obfuscate.branchinsertion.BranchInsertion,105,1,0,0,106,CLASS
,/:sandmark.obfuscate.branchinsertion.BranchInsertion2,100,1,0,0,101,CLASS
,/:sandmark.obfuscate.modifyifelse.ModifyIfElse,320,1,0,0,321,CLASS
,/:sandmark.obfuscate.encryptclasses.JarEncrypter,217,1,0,0,218,CLASS
,/:sandmark.obfuscate.encryptclasses.EncryptedClassLoader,82,1,0,0,83,CLASS
,/:sandmark.obfuscate.stringencoder.LFStringEncoder,348,1,0,0,349,CLASS
,/:sandmark.obfuscate.Obfuscator,31,1,0,0,32,CLASS
,/:sandmark.obfuscate.MethodObfuscator,4,1,0,0,5,CLASS
,/:sandmark.obfuscate.exceptionbranches.DispatcherException,289,1,0,0,290,CLASS
,/:sandmark.obfuscate.exceptionbranches.ExceptionBranches,444,1,0,0,445,CLASS
,/:sandmark.obfuscate.nodesplitter.NodeSplitter,368,1,0,0,369,CLASS
,/:sandmark.obfuscate.localvar.VariableReassigner,84,1,0,0,85,CLASS
,/:sandmark.obfuscate.AppObfuscator,5,1,0,0,6,CLASS
,/:sandmark.obfuscate.irreducibility.Irreducibility,315,1,0,0,316,CLASS
,/:sandmark.obfuscate.blockmarker.BlockMarker,114,1,0,0,115,CLASS
,/:sandmark.obfuscate.objectify.Objectify,93,1,0,0,94,CLASS
,/:sandmark.obfuscate.varsplitter.VarSplitter,211,1,0,0,212,CLASS
,/:sandmark.obfuscate.ArrayObfuscation.Folder,467,1,0,0,468,CLASS
,/:sandmark.obfuscate.ArrayObfuscation.arr,159,1,0,0,160,CLASS
,/:sandmark.obfuscate.ArrayObfuscation.IntArraySplitter,1655,1,0,0,1656,CLASS
,/:sandmark.obfuscate.ArrayObfuscation.HashHolder,285,1,0,0,286,CLASS
,/:sandmark.obfuscate.ArrayObfuscation.ArrayFolder,592,1,0,0,593,CLASS
,/:sandmark.obfuscate.ArrayObfuscation.ArraySplitter,592,1,0,0,593,CLASS
,/:sandmark.obfuscate.buggycode.BugCode,351,1,0,0,352,CLASS
,/:sandmark.obfuscate.inliner.Inliner,119,1,0,0,120,CLASS
,/:sandmark.obfuscate.classsplitter.ClassSplitter,316,1,0,0,317,CLASS
,/:sandmark.obfuscate.classsplitter.FalseRefactor,107,1,0,0,108,CLASS
,/:sandmark.obfuscate.promotelocals.PromoteLocals,55,1,0,0,56,CLASS
,/:sandmark.obfuscate.boguspredicates.bogusPredicates,182,1,0,0,183,CLASS
,/:sandmark.obfuscate.GeneralObfuscator,5,1,0,0,6,CLASS
,/:sandmark.obfuscate.methodmadness.MethodMerger,69,1,0,0,70,CLASS
,/:sandmark.obfuscate.methodmadness.StaticSplit,67,1,0,0,68,CLASS
,/:sandmark.obfuscate.methodmadness.ParamReorder,56,1,0,0,57,CLASS
,/:sandmark.obfuscate.methodmadness.SignatureBludgeoner,56,1,0,0,57,CLASS
,/:sandmark.obfuscate.methodmadness.Method2RMadness,157,1,0,0,158,CLASS
,/:sandmark.obfuscate.methodmadness.PrimitivePromoter,63,1,0,0,64,CLASS
,/:sandmark.obfuscate.reorder.constantpool.CPReorderer,235,1,0,0,236,CLASS
,/:sandmark.obfuscate.scalarmerger.ScalarMerger,224,1,0,0,225,CLASS
,/:sandmark.obfuscate.instructionordering.InstructionOrdering,174,1,0,18,193,CLASS
,/:sandmark.obfuscate.instructionordering.InstructionOrdering$BlockComparator,18,0,0,0,18,INNER_CLASS
,/:sandmark.obfuscate.ObfuscationException,7,1,0,0,8,CLASS
,/:sandmark.obfuscate.insertopaquepred.InsertOpaquePred,108,1,0,0,109,CLASS
,/:sandmark.obfuscate.nameoverloading.NameOverloading,194,1,0,50,245,CLASS
,/:sandmark.obfuscate.nameoverloading.NameOverloading$MethodNameAndSig,25,0,0,0,25,INNER_CLASS
,/:sandmark.obfuscate.nameoverloading.NameOverloading$FieldNameAndSig,25,0,0,0,25,INNER_CLASS
,/:sandmark.obfuscate.appendboguscode.AppendBogusCode,118,1,0,0,119,CLASS
,/:sandmark.obfuscate.AllClassesObfuscator,12,1,0,0,13,CLASS
,/:sandmark.obfuscate.paramalias.ParamAlias,221,1,0,0,222,CLASS
,/:sandmark.obfuscate.interleavemethods.Interleaver,679,1,0,0,680,CLASS
,/:sandmark.obfuscate.interleavemethods.InterleavedMethod,19,1,0,0,20,CLASS
,/:sandmark.obfuscate.interleavemethods.InterleaveUtil,102,1,0,0,103,CLASS
,/:sandmark.obfuscate.interleavemethods.InterleaveMethods,528,1,0,43,572,CLASS
,/:sandmark.obfuscate.interleavemethods.InterleaveMethods$MethodBundle,22,0,0,0,22,INNER_CLASS
,/:sandmark.obfuscate.interleavemethods.InterleaveMethods$Bundle,21,0,0,0,21,INNER_CLASS
,/:sandmark.obfuscate.interleavemethods.StackOp,7,1,0,0,8,CLASS
,/:sandmark.obfuscate.interleavemethods.TypeIndex,37,1,0,0,38,CLASS
,/:sandmark.obfuscate.setfieldspublic.SetFieldsPublic,48,1,0,0,49,CLASS
,/:sandmark.obfuscate.ClassObfuscator,4,1,0,0,5,CLASS
,/:sandmark.obfuscate.addbogusfields.AddBogusFields,116,1,0,0,117,CLASS
,/:sandmark.birthmark.GeneralBirthmark,1,1,0,0,2,CLASS
,/:sandmark.birthmark.BirthmarkException,5,1,0,0,6,CLASS
,/:sandmark.birthmark.StaticClassBirthmark,4,1,0,0,5,CLASS
,/:sandmark.birthmark.methodcalls.MethodComparator,20,1,0,0,21,CLASS
,/:sandmark.birthmark.methodcalls.SMCTriple,36,1,0,0,37,CLASS
,/:sandmark.birthmark.methodcalls.SMC,109,1,0,0,110,CLASS
,/:sandmark.birthmark.fieldvalues.CVFVPair,30,1,0,0,31,CLASS
,/:sandmark.birthmark.fieldvalues.CVFV,87,1,0,0,88,CLASS
,/:sandmark.birthmark.wpp.TracePoint,42,1,0,0,43,CLASS
,/:sandmark.birthmark.wpp.WPP,324,1,0,0,325,CLASS
,/:sandmark.birthmark.wpp.rule,66,2,0,0,68,CLASS
,/:sandmark.birthmark.wpp.Annotate,57,1,0,0,58,CLASS
,/:sandmark.birthmark.wpp.symbol,91,2,0,0,93,CLASS
,/:sandmark.birthmark.wpp.DAGNode,26,1,0,0,27,CLASS
,/:sandmark.birthmark.wpp.Tracer,69,1,0,18,88,CLASS
,/:sandmark.birthmark.wpp.Tracer$Breakpoint,18,0,0,0,18,INNER_CLASS
,/:sandmark.birthmark.wpp.guard,20,1,0,0,21,CLASS
,/:sandmark.birthmark.wpp.RunSequitur,33,1,0,0,34,CLASS
,/:sandmark.birthmark.wpp.DAGEdge,35,1,0,0,36,CLASS
,/:sandmark.birthmark.wpp.Annotator,6,1,0,0,7,CLASS
,/:sandmark.birthmark.wpp.nonTerminal,30,1,0,0,31,CLASS
,/:sandmark.birthmark.wpp.terminal,11,1,0,0,12,CLASS
,/:sandmark.birthmark.util.KnownClassesManager,22,1,0,0,23,CLASS
,/:sandmark.birthmark.Birthmark,61,1,0,0,62,CLASS
,/:sandmark.birthmark.DynamicBirthmark,4,1,0,0,5,CLASS
,/:sandmark.birthmark.DynamicBirthMarkParameters,49,1,0,0,50,CLASS
,/:sandmark.birthmark.StaticClassBirthMarkParameters,27,1,0,0,28,CLASS
,/:sandmark.birthmark.inheritstruct.IS,87,1,0,0,88,CLASS
,/:sandmark.birthmark.usedclasses.UC,143,1,0,0,144,CLASS
,/:sandmark.birthmark.windows.Window,20,1,0,0,21,CLASS
,/:sandmark.birthmark.windows.WindowState,81,1,0,0,82,CLASS
,/:sandmark.birthmark.windows.SlidingWindow,124,1,0,0,125,CLASS
,/:sandmark.wizard.modeling.CorruptStateException,5,1,0,0,6,CLASS
,/:sandmark.wizard.modeling.wmdag.WMDAGNode,29,1,0,0,30,CLASS
,/:sandmark.wizard.modeling.wmdag.WMDAG,247,1,0,0,248,CLASS
,/:sandmark.wizard.modeling.Choice,18,1,0,0,19,CLASS
,/:sandmark.wizard.modeling.lazydfa.LazyDFAModel,109,1,0,21,131,CLASS
,/:sandmark.wizard.modeling.lazydfa.LazyDFAModel$EdgeChoice,7,0,0,0,7,INNER_CLASS
,/:sandmark.wizard.modeling.lazydfa.LazyDFAModel$DFAEdgeIterator,14,0,0,0,14,INNER_CLASS
,/:sandmark.wizard.modeling.lazydfa.LazyDFAEdge,39,1,0,0,40,CLASS
,/:sandmark.wizard.modeling.lazydfa.LazyDFANode,114,1,0,16,131,CLASS
,/:sandmark.wizard.modeling.lazydfa.LazyDFANode$Tuple,16,0,0,0,16,INNER_CLASS
,/:sandmark.wizard.modeling.lazydfa.LazyDFA,151,1,0,0,152,CLASS
,/:sandmark.wizard.modeling.Model,21,1,0,0,22,INTERFACE
,/:sandmark.wizard.modeling.set.PriorityQueue,65,1,0,0,66,CLASS
,/:sandmark.wizard.modeling.set.SetModel,251,1,0,74,326,CLASS
,/:sandmark.wizard.modeling.set.SetModel$ChoiceList,53,0,0,0,53,INNER_CLASS
,/:sandmark.wizard.modeling.set.SetModel$SetModelIterator,21,0,0,0,21,INNER_CLASS
,/:sandmark.wizard.modeling.set.CandidateSet,85,1,0,0,86,CLASS
,/:sandmark.wizard.modeling.dfa.WeightMap,44,1,0,0,45,CLASS
,/:sandmark.wizard.modeling.dfa.WeightPrimer,169,1,0,0,170,CLASS
,/:sandmark.wizard.modeling.dfa.DFA,382,1,0,0,383,CLASS
,/:sandmark.wizard.modeling.dfa.DFANode,25,1,0,0,26,CLASS
,/:sandmark.wizard.modeling.dfa.DFAEdge,43,1,0,0,44,CLASS
,/:sandmark.wizard.modeling.dfa.IntermediateDFA,14,1,0,0,15,INTERFACE
,/:sandmark.wizard.modeling.dfa.PostreqDFA,71,1,0,0,72,CLASS
,/:sandmark.wizard.modeling.dfa.DFAModel,155,1,0,39,195,CLASS
,/:sandmark.wizard.modeling.dfa.DFAModel$EdgeChoice,7,0,0,0,7,INNER_CLASS
,/:sandmark.wizard.modeling.dfa.DFAModel$ChoiceList,32,0,0,0,32,INNER_CLASS
,/:sandmark.wizard.modeling.dfa.PostprohibitDFA,54,1,0,0,55,CLASS
,/:sandmark.wizard.modeling.dfa.PrereqDFA,48,1,0,0,49,CLASS
,/:sandmark.wizard.modeling.dfa.PreprohibitDFA,59,1,0,0,60,CLASS
,/:sandmark.wizard.modeling.Util,337,1,0,14,352,CLASS
,/:sandmark.wizard.modeling.Util$DependencyEdge,14,0,0,0,14,INNER_CLASS
,/:sandmark.wizard.modeling.ModelChangeListener,5,1,0,0,6,INTERFACE
,/:sandmark.wizard.AppProvider,7,1,0,0,8,CLASS
,/:sandmark.wizard.DefaultAlgorithmProvider,27,1,0,0,28,CLASS
,/:sandmark.wizard.DefaultObjectProvider,25,1,0,0,26,CLASS
,/:sandmark.wizard.StaticWatermarkProvider,12,1,0,0,13,CLASS
,/:sandmark.wizard.executive.DAGWatermark,85,1,0,0,86,CLASS
,/:sandmark.wizard.executive.RandomWatermark,104,1,0,0,105,CLASS
,/:sandmark.wizard.evaluation.Evaluator,7,1,0,0,8,INTERFACE
,/:sandmark.wizard.evaluation.FixedChange,33,1,0,0,34,CLASS
,/:sandmark.wizard.evaluation.swmetric.Metrics,22,1,0,0,23,CLASS
,/:sandmark.wizard.evaluation.swmetric.MetricSummary,41,1,0,0,42,CLASS
,/:sandmark.wizard.evaluation.swmetric.MetricChange,219,1,0,0,220,CLASS
,/:sandmark.wizard.evaluation.swmetric.StatisticsPrimer,56,1,0,0,57,CLASS
,/:sandmark.wizard.evaluation.hprof.Hprof,131,1,0,22,154,CLASS
,/:sandmark.wizard.evaluation.hprof.Hprof$CPU_Data,22,0,0,0,22,INNER_CLASS
,/:sandmark.wizard.evaluation.EvaluationListener,3,1,0,0,4,INTERFACE
,/:sandmark.wizard.AlgorithmProvider,4,1,0,0,5,INTERFACE
,/:sandmark.wizard.decision.Strategy,6,1,0,0,7,INTERFACE
,/:sandmark.wizard.decision.priority.MaxPriorityStrategy,80,1,0,10,91,CLASS
,/:sandmark.wizard.decision.priority.MaxPriorityStrategy$ChoiceWrapper,10,0,0,0,10,INNER_CLASS
,/:sandmark.wizard.decision.random.Random,22,1,0,0,23,CLASS
,/:sandmark.wizard.decision.AllAlgsOnce,21,4,0,0,25,CLASS
,/:sandmark.wizard.ChoiceRunner,40,1,0,0,41,CLASS
,/:sandmark.wizard.Wizard,30,1,0,0,31,CLASS
,/:sandmark.wizard.ChoiceRunListener,3,1,0,0,4,INTERFACE
,/:sandmark.wizard.quickprotect.QuickProtect,7,1,0,0,8,INTERFACE
,/:sandmark.wizard.quickprotect.DefaultQuickProtect,20,1,0,0,21,CLASS
,/:sandmark.wizard.quickprotect.CustomQuickProtect,36,3,0,0,39,CLASS
,/:sandmark.wizard.quickprotect.StaticWatermark,26,1,0,0,27,CLASS
,/:sandmark.wizard.quickprotect.AllAlgsOnce,20,1,0,0,21,CLASS
,/:sandmark.wizard.ObjectProvider,6,1,0,0,7,INTERFACE
,/:sandmark.view.View,28,1,0,0,29,CLASS
Total,,91845,880,0,4691,97416